Median Gross Rent(monthly),Total Household Income(yearly),Total population,Transportation To Work,Wage,Health Insurance Coverage,Employment Status,Bedrooms,Total Contract Rent,Total Rent Asked,Total Gross Rent,Aggregate Gross Rent,Median Value,Total Price Asked,Selected Monthly Owner Costs,Monthly Housing Cost,Median Value 18,Value Increase Index(17-18)
513,11026,34933,89,4509,34694,28052,13010,2247,254,2247,515800.0,88900,181,8779,11026,74700,0.0
390,3976,11297,28,1630,11292,9308,5332,938,28,938,167100.0,91000,0,3038,3976,83700,0.0
429,7132,21661,0,3709,21632,17006,8726,1778,102,1778,280600.0,76600,140,5354,7132,81600,1.0
372,53341,148863,182,25077,146078,120893,66368,18695,1590,18695,4676400.0,98600,1578,34646,53341,89500,0.0
395,14278,38970,35,5790,38822,31785,17733,5330,246,5330,1036000.0,99900,351,8948,14278,89300,0.0
626,22205,74169,331,13811,74019,59855,25828,3696,408,3696,1563000.0,142800,546,18509,22205,99700,0.0
568,27802,81905,817,16097,81704,66674,34589,7327,800,7327,2419700.0,131000,973,20475,27802,62300,0.0
639,2555,8931,0,1188,8931,7136,5101,556,232,556,190500.0,108100,195,1999,2555,80900,0.0
428,11989,35025,0,4817,34966,28515,14742,3394,26,3394,651500.0,87800,56,8595,11989,108000,1.0
380,12824,39470,30,6103,39421,32605,17385,3252,342,3252,664400.0,87500,234,9572,12824,52300,0.0
536,49386,134269,619,28618,133655,109743,58048,15657,1825,15657,6255900.0,133300,1586,33729,49386,94700,0.0
512,14603,46779,212,8153,46662,37265,17906,3347,234,3347,801200.0,115900,359,11256,14603,170400,1.0
521,12998,41181,159,6732,41064,33252,15950,3828,331,3828,1010900.0,117500,458,9170,12998,131300,1.0
457,13783,39796,0,7297,39758,32190,16462,3276,280,3276,1206200.0,88300,287,10507,13783,91400,0.0
694,12029,37722,46,6879,37634,30129,15750,2748,362,2748,1259500.0,143300,419,9281,12029,63500,0.0
484,6636,18952,63,3507,18843,15488,10462,1959,142,1959,633800.0,109200,294,4677,6636,95400,0.0
417,9109,29237,48,3701,29133,23070,10884,2067,212,2067,631300.0,90600,435,7042,9109,117800,1.0
367,6797,21906,42,2586,21814,17660,8528,2130,149,2130,293900.0,89300,99,4667,6797,118600,1.0
483,13670,38689,232,7031,38629,31537,16387,3257,214,3257,990000.0,111000,635,10413,13670,79700,0.0
416,9255,27892,20,4651,27814,23099,12557,2048,412,2048,427200.0,91200,229,7207,9255,71200,0.0
473,4532,12238,20,2136,12228,10048,7448,1153,229,1153,335500.0,94000,95,3379,4532,80000,0.0
372,5949,17325,11,2269,17307,14060,7335,1990,30,1990,292200.0,93400,60,3959,5949,161100,1.0
386,6075,19914,76,2582,19914,16082,7537,2251,266,2251,430900.0,87800,151,3824,6075,128600,1.0
479,15230,43314,65,6744,43044,35660,20354,5556,472,5556,1542700.0,103100,486,9674,15230,78500,0.0
384,4818,15297,0,2193,15044,12311,6189,1799,162,1799,393100.0,90700,69,3019,4818,60800,0.0
397,10051,27321,14,4289,27107,22516,12228,4382,116,4382,686100.0,86400,129,5669,10051,81400,0.0
517,12534,38253,0,6122,38212,30972,15619,3207,248,3207,909200.0,115600,225,9327,12534,160000,1.0
553,15938,51768,244,9256,50995,42587,22981,3775,271,3775,1303200.0,114300,393,12163,15938,117800,0.0
459,145321,355181,9099,77329,351733,295774,191901,67050,9238,67050,27780000.0,158000,4903,78271,145321,93200,0.0
498,12529,38589,269,5973,37769,30865,16090,3846,233,3846,1122600.0,118500,247,8683,12529,77400,0.0
511,17746,54754,120,8174,54577,44583,24648,2893,218,2893,858300.0,115100,475,14853,17746,83100,0.0
284,1914,6180,0,1034,6180,5055,2623,500,8,500,57700.0,92900,25,1414,1914,66000,0.0
443,8573,24008,11,3843,23970,19648,9945,1703,67,1703,605100.0,109300,318,6870,8573,97900,0.0
342,6575,19578,0,2809,19509,15709,8278,1998,184,1998,238400.0,82100,140,4577,6575,109800,1.0
407,12627,39704,0,6640,39645,31820,15538,3700,140,3700,903700.0,112800,315,8927,12627,115200,0.0
417,8059,23893,23,3184,23846,19876,12094,3493,155,3493,360400.0,91400,123,4566,8059,83000,0.0
464,7568,23610,23,3072,23499,19377,10767,1891,155,1891,370400.0,95800,1157,5677,7568,95000,0.0
370,6166,18525,0,2500,18473,14895,7705,2802,110,2802,531200.0,81700,60,3364,6166,61800,0.0
419,11571,32936,12,5566,32852,26986,14148,3542,227,3542,700700.0,108300,352,8029,11571,83100,0.0
410,5528,17327,0,1964,17308,14035,9347,1445,292,1445,192000.0,87700,1091,4083,5528,120700,1.0
393,6271,16474,113,2852,16454,13750,7669,1625,251,1625,488900.0,104700,145,4646,6271,144400,1.0
474,15703,40705,40,7361,40567,33036,18742,4121,946,4121,1267700.0,106600,652,11582,15703,188600,1.0
430,8346,26584,22,3848,26547,21199,11570,1728,281,1728,432400.0,91900,263,6618,8346,57500,0.0
478,8696,29112,36,4265,29060,23583,10634,1841,210,1841,434400.0,94500,58,6855,8696,131800,1.0
391,11922,32937,8,5132,32844,27199,15689,3336,299,3336,886400.0,94800,232,8586,11922,79700,0.0
386,9727,30209,8,4077,30189,24695,13315,3454,347,3454,657300.0,93500,330,6273,9727,70000,0.0
403,32308,89550,145,14306,88560,74069,41382,10355,898,10355,2270500.0,96600,687,21953,32308,144500,1.0
467,6127,18504,47,2561,18491,14816,8503,1289,150,1289,555900.0,87700,282,4838,6127,84200,0.0
397,9068,25595,597,4696,25563,20622,10725,3596,253,3596,955400.0,125000,184,5472,9068,99600,0.0
532,4300,12140,0,2234,12122,9813,4904,1054,100,1054,303000.0,94500,23,3246,4300,68700,0.0
436,14443,40978,23,7191,40942,33685,16829,3721,370,3721,899600.0,97500,204,10722,14443,84100,0.0
435,18378,54736,19,8779,54361,44938,26825,4954,817,4954,1464100.0,97300,588,13424,18378,81400,0.0
444,15964,47952,178,8952,47661,38229,18905,4061,164,4061,951100.0,93300,198,11903,15964,68800,0.0
489,10129,31785,71,4970,31762,25495,11807,2999,133,2999,665900.0,98000,76,7130,10129,76500,0.0
410,29769,79615,252,12515,79055,67025,41149,12329,2995,12329,3874900.0,99800,1192,17440,29769,73400,0.0
435,7759,22475,13,4134,22475,17731,9417,2080,84,2080,751800.0,92800,130,5679,7759,92100,0.0
544,24357,69478,414,15819,69192,56501,29385,8046,690,8046,3010900.0,152400,626,16311,24357,88200,0.0
449,8491,24548,0,3861,24541,20019,10387,3197,114,3197,710700.0,109600,193,5294,8491,73900,0.0
376,14989,42623,37,6518,40427,34571,18794,4088,232,4088,1450200.0,90800,470,10901,14989,83100,0.0
425,12975,37676,18,5716,37463,30346,15744,4319,395,4319,958800.0,97300,208,8656,12975,92800,0.0
595,520,1494,0,240,1494,1229,1512,171,243,171,65300.0,89600,26,349,520,87400,0.0
676,15223,47074,141,9640,46896,37834,17446,2683,320,2683,1142000.0,147500,489,12540,15223,78600,0.0
399,10718,29239,46,5500,29074,23348,13858,2039,106,2039,570200.0,85900,282,8679,10718,68900,0.0
478,8090,24583,31,3609,24556,19804,9935,2107,313,2107,582000.0,101900,232,5983,8090,102000,0.0
410,8919,27242,510,4840,27209,21804,11558,2525,17,2525,541900.0,105200,212,6394,8919,98600,0.0
379,10749,37585,189,4482,37382,30895,17344,2554,627,2554,308100.0,91500,2169,8195,10749,100400,1.0
686,32913,90773,863,19898,90432,76332,40052,8676,791,8676,4913500.0,191200,1403,24237,32913,99000,0.0
416,21322,55722,61,9652,54072,45638,27301,8361,1033,8361,2211800.0,119700,529,12961,21322,124600,0.0
433,16495,49726,10,7302,49581,40964,29668,6854,253,6854,965100.0,114100,364,9641,16495,91600,0.0
483,12436,33075,113,6546,32887,26770,18522,4323,254,4323,1322700.0,102300,610,8113,12436,91400,0.0
315,3033,8874,0,1421,8799,7159,3919,929,11,929,141800.0,73100,56,2104,3033,122300,1.0
332,6501,17769,0,2813,17769,14573,8973,1913,49,1913,314400.0,94800,13,4588,6501,74900,0.0
444,5079,14526,0,2347,14486,12213,9447,1373,646,1373,283100.0,122200,311,3706,5079,105400,0.0
392,7761,23659,9,4499,23477,18999,9097,2192,132,2192,395000.0,93800,166,5569,7761,155000,1.0
443,8594,26855,151,3892,26739,21897,10794,2884,365,2884,448300.0,115000,109,5710,8594,74700,0.0
547,69318,188614,2915,40797,182918,156567,83381,21503,2789,21503,8468700.0,138200,2878,47815,69318,127900,0.0
593,64056,161684,1488,39848,160992,133656,77499,19640,1994,19640,9349100.0,146400,1413,44416,64056,85600,0.0
455,16459,45431,100,8489,45377,37159,20096,5651,442,5651,1625800.0,119500,376,10808,16459,114500,0.0
499,8207,21745,15,3911,21518,17228,11375,3201,157,3201,837200.0,88000,28,5006,8207,116500,1.0
531,13056,33288,15,8429,33050,26846,15347,2613,55,2613,1133100.0,98700,281,10443,13056,116600,1.0
818,59001,156597,523,44976,154952,126616,67087,24069,2539,24069,19729300.0,157100,950,34932,59001,81300,0.0
517,12453,30058,5,7759,29540,24401,14811,3032,431,3032,1319200.0,87200,241,9421,12453,82700,0.0
429,7620,20170,62,4593,18987,16554,9538,2005,92,2005,752400.0,91800,90,5615,7620,104500,1.0
534,5073,13084,13,2889,12946,10788,6833,1799,122,1799,823500.0,69500,27,3274,5073,151100,1.0
847,261390,659460,2695,191489,652283,524242,306110,97191,11546,97191,81191800.0,149000,6042,164199,261390,114400,0.0
521,5463,13188,0,2921,13060,10850,7329,1084,14,1084,442400.0,69000,6,4379,5463,122200,1.0
596,11533,31507,27,7736,31272,24597,14132,3591,597,3591,1766700.0,87600,456,7942,11533,129400,1.0
552,7975,19743,0,4505,19526,15822,10307,2286,98,2286,1037400.0,88100,100,5689,7975,216600,1.0
759,22690,58480,62,16549,56790,45502,27170,9322,1522,9322,6948900.0,114700,628,13368,22690,120700,1.0
596,10795,25855,38,6192,25561,21387,16466,2360,453,2360,1266200.0,116300,362,8435,10795,140100,1.0
589,15285,37519,26,9523,36970,30269,18890,3809,532,3809,1895300.0,96200,559,11476,15285,84100,0.0
532,5358,13866,6,3324,13666,11123,6775,1553,151,1553,639900.0,76800,283,3805,5358,107500,1.0
599,16487,40755,28,9950,40454,31802,20309,6732,566,6732,3533500.0,80800,297,9755,16487,71900,0.0
633,38634,92590,54,25504,91721,76051,44537,12204,1109,12204,6854900.0,126800,725,26430,38634,121400,0.0
624,4309,10362,15,2519,10268,8151,5158,1146,56,1146,392100.0,63000,68,3163,4309,146000,1.0
603,7852,19358,71,4901,19141,16305,10264,2773,382,2773,1346200.0,77100,164,5079,7852,85000,1.0
622,32386,91695,30,23003,88681,73004,35859,7407,546,7407,4464700.0,146300,914,24979,32386,172400,1.0
975,76868,208721,94,60718,207053,164092,85043,15679,2006,15679,15466900.0,199500,1321,61189,76868,98300,0.0
723,32486,86937,41,23550,85000,69004,36524,6370,469,6370,4358900.0,142800,480,26116,32486,162900,1.0
528,9439,23968,2,5698,23646,19583,13594,2144,85,2144,795800.0,82900,203,7295,9439,141200,1.0
904,76133,203360,93,51520,200929,163759,110023,20663,15936,20663,17610200.0,182000,3510,55470,76133,74600,0.0
644,31097,81703,19,19932,80867,65472,37524,7826,752,7826,4332500.0,121900,380,23271,31097,83600,0.0
825,29115,80989,46,20799,75789,64931,33798,7870,533,7870,5943800.0,155300,766,21245,29115,118100,0.0
725,39560,104108,53,27419,103300,82515,46869,13990,2267,13990,9710900.0,127100,866,25570,39560,87200,0.0
607,20368,52326,2,12669,51817,42482,25019,5376,1092,5376,2546500.0,105000,839,14992,20368,75400,0.0
598,31651,80888,145,20890,77941,65310,37563,8792,747,8792,4925500.0,95200,934,22859,31651,88100,0.0
816,71507,204424,361,53755,202930,165890,89419,26587,2253,26587,21318500.0,161700,671,44920,71507,158100,0.0
657,6001,16746,0,3744,16621,13555,8481,1055,110,1055,382000.0,83900,17,4946,6001,87000,0.0
482,5338,13407,0,3390,13153,10878,6797,1256,71,1256,485800.0,89300,104,4082,5338,75500,0.0
731,19620,51073,3,14174,49425,40416,23038,6798,757,6798,5007500.0,147800,408,12822,19620,138500,0.0
622,45904,119157,60,31750,117243,94892,51778,13046,1290,13046,7868500.0,128200,1008,32858,45904,136100,1.0
637,12284,33287,3,8317,33081,27498,16010,5007,1534,5007,3145100.0,109200,467,7277,12284,129300,1.0
678,16768,43805,18,11618,43473,34509,19518,4143,447,4143,2333100.0,98600,393,12625,16768,190100,1.0
655,21983,54435,21,14495,53993,44236,26333,5974,875,5974,3672600.0,108500,673,16009,21983,165400,1.0
547,4204,10955,24,2348,10563,9295,6527,827,80,827,292300.0,87300,192,3377,4204,116400,1.0
672,18825,49393,28,13196,46471,39173,23000,7588,992,7588,5267200.0,108000,330,11237,18825,179800,1.0
483,5664,14995,0,3284,14762,12000,7753,1423,28,1423,504100.0,88800,87,4241,5664,105000,1.0
634,39061,103132,104,25322,102339,83397,47639,10965,936,10965,6147400.0,105100,495,28096,39061,117900,1.0
579,25482,71194,12,16427,70448,55678,31384,7327,1156,7327,3470000.0,102900,1327,18155,25482,83700,0.0
580,13226,37621,12,7731,34883,30205,16556,3736,482,3736,1906300.0,94500,145,9490,13226,103500,1.0
409,6019,14021,30,3818,13856,11279,7390,1459,105,1459,522200.0,71500,49,4560,6019,123500,1.0
588,8867,22530,10,5346,22276,18119,12043,2419,208,2419,1146200.0,85200,197,6448,8867,90200,1.0
585,7050,20126,0,4571,19832,16078,10008,2110,634,2110,1008600.0,88800,1060,4940,7050,73700,0.0
828,153794,414328,768,109296,406941,326953,182505,51743,9274,51743,40313000.0,124500,4198,102051,153794,115200,0.0
566,4716,12649,14,2672,12603,10118,7125,1058,208,1058,489900.0,76100,287,3658,4716,158300,1.0
512,3039,9680,0,1361,9532,7801,4748,752,71,752,217100.0,69100,216,2287,3039,101700,1.0
609,25143,64927,61,16045,64196,52131,30988,6124,290,6124,3137700.0,87300,461,19019,25143,160600,1.0
549,5773,14939,0,3527,14758,11843,6781,1477,50,1477,687500.0,111800,25,4296,5773,116100,0.0
533,3025,8533,0,1578,8480,6681,5056,967,35,967,373600.0,67700,19,2058,3025,139000,1.0
569,9191,26201,22,5860,23326,21241,11918,3446,386,3446,1772600.0,89300,228,5745,9191,134800,1.0
710,6916,22580,53,4607,20553,18415,9112,1704,89,1704,1059000.0,105500,101,5212,6916,151200,1.0
611,3670,10478,11,2381,10113,8517,4516,1100,57,1100,587700.0,66800,8,2570,3670,84300,1.0
645,45099,115527,114,31039,113964,93148,53655,13804,1072,13804,8224700.0,110100,1174,31295,45099,128200,1.0
684,13694,33895,23,9035,33513,27447,16989,4591,510,4591,2815900.0,86400,365,9103,13694,110300,1.0
546,9602,24625,12,5406,24341,19863,12704,3266,125,3266,1194900.0,93500,97,6336,9602,118400,1.0
523,6955,16657,0,4458,16468,13535,8453,1610,82,1610,684800.0,83200,117,5345,6955,107900,1.0
846,89776,227120,655,67237,222268,179373,103967,36713,3827,36713,31193200.0,124100,1782,53063,89776,144200,1.0
615,34588,94738,112,22845,93913,73909,40590,10151,648,10151,5794500.0,118500,871,24437,34588,171800,1.0
649,20690,57667,29,13926,57207,45924,24161,4444,461,4444,2320300.0,122200,376,16246,20690,152400,1.0
603,6727,17110,0,4436,16828,13972,9055,1196,222,1196,612900.0,112600,251,5531,6727,131100,1.0
801,142253,353213,336,109542,348398,283489,157000,46222,4609,46222,37041500.0,173400,2668,96031,142253,111900,0.0
932,21054,55036,14,15554,54170,42974,23152,5624,311,5624,5524000.0,143000,210,15430,21054,87200,0.0
614,16369,40756,14,10261,40211,33010,22258,4606,346,4606,2520400.0,107000,422,11763,16369,94900,0.0
589,10693,26572,4,6678,26211,21448,12756,2820,186,2820,1396900.0,87800,250,7873,10693,157500,1.0
494,3841,10919,0,1869,10621,8560,5709,1453,25,1453,324200.0,81600,66,2388,3841,75300,0.0
1294,4538,13773,2,3823,13196,10482,5373,1859,67,1859,2050000.0,267700,92,2679,4538,101100,0.0
871,678,2303,7,542,2269,2023,1669,145,8,145,104400.0,224200,51,533,678,122900,0.0
974,2849,9439,10,2368,9174,7371,6169,757,193,757,653100.0,252200,124,2092,2849,100500,0.0
994,21779,57961,245,15553,56797,46161,31016,6271,603,6271,5994600.0,234600,624,15508,21779,106100,0.0
1277,1218,5784,0,1114,5588,4892,1980,851,58,851,549100.0,238800,17,367,1218,208900,0.0
1051,358,917,1,294,902,740,941,153,49,153,121200.0,186700,6,205,358,160700,0.0
1229,1849,7715,7,1588,7689,5300,2713,794,77,794,759000.0,145800,4,1055,1849,140900,0.0
1253,4524,17957,32,3985,17659,12200,5995,1663,92,1663,1473900.0,152600,27,2861,4524,122900,0.0
1029,2041,9757,10,1725,9677,7551,2591,981,91,981,829200.0,153900,17,1060,2041,255700,1.0
1104,3545,8810,53,2767,8631,7106,4175,1537,154,1537,1488600.0,350900,97,2008,3545,119400,0.0
1272,36396,100031,472,31434,92924,78105,43866,14930,2073,14930,19373400.0,230600,444,21466,36396,89800,0.0
1139,5270,13745,210,4119,13474,10963,6310,2009,217,2009,2218700.0,265700,71,3261,5270,114000,0.0
1098,30613,101135,335,24027,99208,76585,41704,7204,754,7204,7542400.0,235600,733,23409,30613,217400,0.0
1030,255,682,3,197,682,548,400,101,13,101,74000.0,185000,4,154,255,163000,0.0
1343,2897,9869,11,2522,9649,6852,4082,1142,80,1142,1143000.0,143000,14,1755,2897,136300,0.0
1039,1405,4974,18,1179,4956,3601,2444,534,54,534,371400.0,189500,11,871,1405,165700,0.0
1016,1087,2537,8,759,2531,2078,1619,318,29,318,276800.0,243100,15,769,1087,136100,0.0
1181,12273,32434,897,10119,31791,26154,13451,4240,281,4240,5016100.0,343100,183,8033,12273,141100,0.0
746,408,1301,1,346,1301,987,1406,130,42,130,74300.0,118500,10,278,408,143300,1.0
1088,2139,6889,19,1618,6780,5214,3915,606,169,606,532600.0,191700,120,1533,2139,120300,0.0
653,1959,5453,6,1523,5425,4105,4067,580,76,580,235500.0,80600,53,1379,1959,277500,1.0
1261,106012,298225,2557,90493,286906,231729,115748,42290,2926,42290,56377700.0,304500,1266,63722,106012,126300,0.0
989,812,3338,2,669,3333,2947,1051,330,41,330,199600.0,124700,9,482,812,89800,0.0
840,2315,6473,33,1694,6473,5103,3411,625,101,625,439700.0,169100,106,1690,2315,116800,0.0
793,1084,2475,7,686,2458,2060,1466,362,56,362,249900.0,194000,24,722,1084,101300,0.0
850,802,2146,16,597,2141,1831,1649,212,23,212,144900.0,226800,41,590,802,156600,0.0
1069,423,1038,7,371,1038,924,654,203,19,203,185400.0,293800,8,220,423,203700,0.0
885,1255,3275,13,885,3263,2608,1828,399,45,399,331400.0,205000,65,856,1255,235300,1.0
625,1752,8129,2,1506,8123,5233,2244,456,20,456,131900.0,88600,12,1296,1752,123500,1.0
861,398530,1007257,10981,277811,987178,814161,453948,151693,15280,151693,136921000.0,166300,7497,246837,398530,216900,1.0
1033,1489533,4155501,41538,1125531,4125142,3240638,1699628,581017,55255,581017,621625800.0,225000,31774,908516,1489533,262600,1.0
767,21585,53145,16,12055,52401,43414,33267,5856,441,5856,4086400.0,153600,713,15729,21585,131800,0.0
793,10976,37700,117,7790,33658,28550,13348,3507,450,3507,2463200.0,123500,794,7469,10976,134900,1.0
627,15568,46358,54,11089,46024,35135,18185,5100,485,5100,3097700.0,138400,556,10468,15568,166000,1.0
805,49160,126516,62,31731,115099,101372,60653,15282,2867,15282,12077200.0,144400,1671,33878,49160,133300,0.0
570,8798,20477,13,4195,20309,17483,16271,2265,479,2265,1250000.0,77400,770,6533,8798,224200,1.0
786,83902,204691,578,45755,200916,172208,113220,26566,2748,26566,20194500.0,138700,2674,57336,83902,259400,1.0
487,19530,71602,183,11258,70807,53700,32748,4366,715,4366,2146000.0,72800,429,15164,19530,102500,1.0
1079,47588,138639,817,37506,137820,112345,64911,19353,1677,19353,19807500.0,241400,826,28235,47588,155000,0.0
919,94343,220972,221,54559,219401,187588,113915,27660,2398,27660,24979400.0,215000,2360,66683,94343,239500,1.0
830,71670,204281,1261,49674,197418,157101,90931,23289,2274,23289,18538700.0,117000,1540,48381,71670,126500,1.0
429,3364,9368,0,2554,9325,7011,4445,1778,233,1778,840400.0,87500,400,1586,3364,118300,1.0
690,34251,107902,310,21120,105552,81333,57638,10656,873,10656,6381200.0,115100,1025,23595,34251,167900,1.0
1014,133513,405537,329,85314,380940,319302,168786,36585,3557,36585,31969900.0,157200,4530,96928,133513,111800,0.0
686,29217,78706,16,20383,78113,62133,33525,9585,1196,9585,6210500.0,116400,544,19632,29217,78300,0.0
661,3452,8528,21,2213,8360,6761,4575,881,78,881,383800.0,62700,67,2571,3452,136000,1.0
593,9325,26688,0,5636,23288,21411,10989,3863,482,3863,1997700.0,61900,223,5462,9325,89400,1.0
825,155435,392848,1717,116542,386754,310166,182288,63932,12158,63932,53183500.0,148300,3908,91503,155435,66800,0.0
557,6428,15190,0,4121,15054,12219,8035,1913,365,1913,949600.0,70000,145,4515,6428,127400,1.0
663,6726,17164,9,4845,16940,13589,7964,2183,391,2183,1190700.0,79400,223,4543,6726,108500,1.0
655,3144,7585,1,1966,6944,6073,4300,988,81,988,533900.0,64500,436,2156,3144,68800,1.0
647,7038,18620,0,4657,18211,15075,8575,2413,442,2413,1236600.0,93200,251,4625,7038,115100,1.0
664,9337,23992,6,6143,23566,19658,11625,3199,305,3199,1591500.0,76200,316,6138,9337,98000,1.0
578,7339,17514,0,4359,17157,13841,8558,2057,110,2057,1006600.0,81500,76,5282,7339,183700,1.0
812,43314,116252,23,31962,115077,91908,47742,9890,786,9890,7956900.0,147400,995,33424,43314,81900,0.0
616,6867,16751,0,3703,16559,13772,10413,1579,182,1579,747800.0,98900,370,5288,6867,185800,1.0
631,14887,37212,15,9834,36790,29695,16966,4158,293,4158,2482600.0,116600,543,10729,14887,67100,0.0
576,5189,13521,0,2895,12641,11353,7263,1107,130,1107,484700.0,79400,502,4082,5189,120700,1.0
618,14288,37097,36,9897,36603,29327,16393,4183,306,4183,2292600.0,104400,421,10105,14288,122600,1.0
539,3928,13885,0,2652,9086,11708,4914,982,76,982,407100.0,66100,64,2946,3928,79100,1.0
562,8269,21802,33,5165,21550,17505,10173,2207,169,2207,1112000.0,90400,192,6062,8269,81100,0.0
727,6851,18076,7,4824,17909,14447,7947,1382,128,1382,862400.0,123500,42,5469,6851,84200,0.0
713,18659,49278,52,13233,48739,37066,21696,8072,1124,8072,5328900.0,106300,358,10587,18659,92900,0.0
598,6862,17803,59,4125,17492,14151,8058,1810,81,1810,937500.0,90600,122,5052,6862,109500,1.0
777,43835,121282,59,33701,120096,95819,49475,16506,2366,16506,12952500.0,153500,581,27329,43835,162600,1.0
512,4313,10893,16,2935,10747,8733,5624,984,93,984,383200.0,78600,156,3329,4313,120300,1.0
702,27377,71373,55,18283,66984,56823,33308,9990,1012,9990,6381400.0,81800,472,17387,27377,114900,1.0
586,6663,16374,12,3580,16244,13770,9414,1439,247,1439,698100.0,117300,346,5224,6663,78300,0.0
551,3855,9059,7,2083,8922,7506,5823,708,43,708,264600.0,96900,126,3147,3855,80600,0.0
492,3972,10584,8,2405,10518,8328,5233,1042,170,1042,405000.0,69800,149,2930,3972,112600,1.0
500,3336,7925,11,1834,7837,6499,4921,687,65,687,279800.0,89700,59,2649,3336,88300,0.0
655,50301,127362,195,35700,126347,99792,56296,20234,1790,20234,13266300.0,116800,915,30067,50301,94800,0.0
667,23870,62119,35,16853,61510,48359,26669,5804,873,5804,3603700.0,112500,283,18066,23870,115500,0.0
845,90906,251823,165,70714,250348,191488,100376,30631,1282,30631,25671700.0,163000,1548,60275,90906,140400,0.0
564,4323,11008,48,2610,10332,8850,5433,1455,246,1455,701000.0,63000,145,2868,4323,140000,1.0
655,12291,33480,75,8272,31439,27197,14416,3094,182,3094,1752000.0,88900,824,9197,12291,114200,1.0
605,9900,26155,39,6403,25958,20323,11423,2889,232,2889,1535800.0,95400,131,7011,9900,136900,1.0
542,3541,9614,0,2105,7998,8040,4369,1578,40,1578,610600.0,67100,3,1963,3541,113100,1.0
644,6190,15907,21,4211,15829,12699,7550,1455,102,1455,689100.0,108500,58,4735,6190,161800,1.0
533,5230,12094,7,3437,12026,9425,6307,2191,107,2191,896500.0,56700,111,3039,5230,135900,1.0
504,5117,12092,52,3073,11923,9940,6808,1120,112,1120,474200.0,91300,360,3997,5117,71400,0.0
555,5042,13472,65,3401,13296,10295,6260,1703,250,1703,721200.0,94100,118,3339,5042,89300,0.0
721,40062,97994,164,25245,96780,80247,50834,13223,1942,13223,9596500.0,131500,1400,26839,40062,135700,0.0
619,17238,43534,43,12173,42774,33476,20542,7516,965,7516,4063300.0,81400,307,9722,17238,116700,1.0
660,23147,63372,46,16103,62737,50475,26103,7636,711,7636,4919700.0,126100,478,15511,23147,113900,0.0
539,3920,8309,0,2528,8175,6820,4528,1144,35,1144,460000.0,65300,47,2776,3920,170700,1.0
650,16189,40022,32,10631,39634,31312,19850,4297,578,4297,2451500.0,79900,339,11892,16189,90700,1.0
484,2874,6763,30,1705,6646,5454,3891,982,161,982,430500.0,63700,55,1892,2874,76300,1.0
676,10646,25361,0,6408,25022,21105,16008,2658,32,2658,1538600.0,127000,368,7988,10646,79100,0.0
621,3292,8332,15,2268,8229,6727,4084,856,15,856,369900.0,87200,32,2436,3292,142300,1.0
576,6179,17429,10,3967,14320,14291,7591,1817,417,1817,998200.0,61300,197,4362,6179,134700,1.0
624,7930,22154,18,5511,21909,17008,10496,2469,483,2469,1336100.0,76200,142,5461,7930,99600,1.0
578,7296,17041,0,3898,16863,13810,9857,1936,217,1936,966300.0,79900,376,5360,7296,120000,1.0
585,4910,12443,0,2451,12342,10270,6839,1120,13,1120,557000.0,107300,73,3790,4910,104900,0.0
743,84460,223683,771,66967,221806,173478,91247,39429,2724,39429,30502200.0,162900,1096,45031,84460,99200,0.0
717,16821,44197,10,11899,43711,34695,18689,5498,275,5498,3713600.0,110400,417,11323,16821,107800,0.0
667,18398,41093,56,10249,40681,34719,22803,4534,548,4534,2788600.0,124400,577,13864,18398,119300,0.0
608,8182,20771,19,5556,20610,16422,10152,2128,541,2128,1051400.0,68200,182,6054,8182,78400,1.0
731,39838,104246,100,30146,103216,81271,44056,16600,1266,16600,11760900.0,134600,644,23238,39838,115100,0.0
406,2860,7051,6,1768,6918,5827,4369,784,120,784,242300.0,65900,50,2076,2860,88200,1.0
663,3692,10320,1,2372,10209,8252,4952,686,191,686,357000.0,99100,133,3006,3692,83900,0.0
595,7555,21601,53,5044,21293,16890,9826,2200,272,2200,1252800.0,100300,267,5355,7555,165800,1.0
571,7823,19518,4,4895,19349,14947,10177,4098,217,4098,2053800.0,67100,278,3725,7823,78200,1.0
564,9483,24098,3,6197,23782,18999,10959,3345,238,3345,1603300.0,78200,319,6138,9483,57800,0.0
547,5984,17206,15,4272,17064,12791,6922,1480,111,1480,633400.0,75400,89,4504,5984,143900,1.0
611,2061,5194,11,1386,5136,4300,2911,347,77,347,158700.0,71000,192,1714,2061,66800,0.0
594,8820,22495,44,6303,22138,18733,10494,3350,218,3350,1757900.0,95000,549,5470,8820,120100,1.0
567,4566,10994,0,2805,10901,8629,5821,1738,192,1738,840300.0,74300,92,2828,4566,174100,1.0
529,6584,16777,14,4143,16483,13462,7994,2162,250,2162,909700.0,77100,68,4422,6584,346500,1.0
492,3328,7420,0,2027,7346,6081,4450,1274,70,1274,503000.0,54500,40,2054,3328,100800,1.0
539,8058,20212,46,4852,20081,16095,10111,1908,141,1908,892700.0,87100,196,6150,8058,74000,0.0
627,8185,20954,20,5070,20821,16514,9783,2382,180,2382,1149000.0,98700,305,5803,8185,173300,1.0
542,10016,24378,79,6297,23997,19393,13095,3282,286,3282,1651900.0,67900,697,6734,10016,85900,1.0
474,3152,7898,20,1741,7835,6506,4684,469,42,469,135500.0,91600,110,2683,3152,151900,1.0
660,7692,18352,0,5294,18112,14747,9454,2870,300,2870,1428000.0,80300,105,4822,7692,200800,1.0
543,5300,12494,0,3407,12333,10024,6494,1609,234,1609,740300.0,72400,20,3691,5300,134700,1.0
764,26281,71568,54,20379,69999,54782,28811,8285,553,8285,5998600.0,135100,638,17996,26281,139100,0.0
592,10832,27782,0,6684,27564,22240,13649,2434,489,2434,1336000.0,121100,325,8398,10832,222900,1.0
710,17020,43760,25,11782,42566,34525,19515,6218,682,6218,4049500.0,108500,213,10802,17020,299400,1.0
739,3638,9017,0,1974,8784,7506,5250,983,39,983,598700.0,143100,258,2655,3638,238300,1.0
934,79261,267390,1077,59177,264519,196540,84488,38055,1679,38055,34443800.0,196200,1225,41206,79261,242200,1.0
914,26327,64095,195,14638,63433,52552,35747,8965,624,8965,8048200.0,182000,1006,17362,26327,183900,0.0
869,7434,17658,84,4322,17489,15105,10378,2175,416,2175,1705000.0,259500,587,5259,7434,190600,0.0
923,25880,74644,255,18291,72464,55880,28225,10817,578,10817,10651200.0,207100,308,15063,25880,232100,1.0
1600,389597,1123678,53523,300275,1118246,892650,409117,134396,4649,134396,215922400.0,522300,3828,255201,389597,220400,0.0
875,8026,18195,95,5280,17785,14908,9526,2917,166,2917,2497100.0,243100,103,5109,8026,310200,1.0
942,9441,31470,40,6215,21739,26937,12749,3211,313,3211,2901500.0,177500,320,6230,9441,222300,1.0
1049,171324,535684,1584,128838,532471,405302,180755,73534,3458,73534,76801500.0,244100,2123,97790,171324,174000,0.0
1496,144015,442996,6355,110488,435899,354581,155339,68707,2892,68707,106174700.0,509400,1137,75308,144015,265000,0.0
1456,190058,500943,4433,136018,496690,410495,207908,75450,2809,75450,108702600.0,513300,1533,114608,190058,226600,0.0
812,23712,63247,52,15328,62714,49743,27359,7778,625,7778,6079200.0,191400,314,15934,23712,124900,0.0
805,45198,179957,446,33312,170512,133703,57198,19691,1167,19691,15900100.0,167700,636,25507,45198,236500,1.0
1103,4899,14058,1521,3673,13968,11575,14041,2149,1275,2149,2073400.0,311700,238,2750,4899,408400,1.0
1369,17440,58671,127,14229,58511,44971,18328,6337,233,6337,8486700.0,459700,264,11103,17440,266000,0.0
1547,569070,1629615,109009,454539,1619367,1321464,596898,267403,8833,267403,421565300.0,649100,3841,301667,569070,162500,0.0
1122,532050,1495400,17390,398151,1480422,1174131,564349,236774,12953,236774,272307000.0,299900,6020,295276,532050,372600,1.0
1122,68084,185015,1377,45891,183777,152022,89286,16136,1045,16136,18827300.0,405900,962,51948,68084,272900,0.0
1541,49044,141005,908,36405,139208,114589,55456,18090,1026,18090,27581200.0,560500,526,30954,49044,216700,0.0
1467,1111739,3283665,46480,861251,3186685,2636785,1195868,522595,26626,522595,801432200.0,484900,10109,589144,1111739,185300,0.0
1338,125939,433168,2025,97416,416786,330852,140548,62066,3774,62066,86469500.0,441000,1462,63873,125939,336600,0.0
1709,358772,864263,166603,274219,859959,759471,390376,224960,8679,224960,398247200.0,927400,4234,133812,358772,195800,0.0
919,1208,2885,0,638,2858,2490,2388,245,2,245,267200.0,157100,55,963,1208,459200,1.0
877,135144,458809,1064,102724,454868,330467,146712,59169,2651,59169,52266000.0,180200,1631,75975,135144,260000,1.0
1204,72845,212605,3578,55337,211123,172147,76916,35036,1315,35036,42771200.0,370800,715,37809,72845,364100,0.0
914,53966,135490,998,35577,134525,111972,62583,23466,1236,23466,22738700.0,285800,865,30500,53966,247600,0.0
1217,40386,98838,483,24470,97938,83915,53393,10411,621,10411,12417600.0,379800,783,29975,40386,448800,1.0
1083,304,1203,0,143,1203,995,1742,51,56,51,62200.0,343800,45,253,304,164800,0.0
980,44458,154440,241,31454,146644,116711,50090,16757,879,16757,15591600.0,220400,740,27701,44458,127200,0.0
1048,34182,87497,72,21079,86720,70894,40851,13952,703,13952,13639400.0,338000,336,20230,34182,112600,0.0
1552,95536,273263,3298,70506,271860,225234,105586,38544,1202,38544,59197500.0,659900,574,56992,95536,108300,0.0
803,5462,13037,0,2801,12863,11217,8814,1704,52,1704,1274500.0,286500,266,3758,5462,86800,0.0
1322,3295198,10105722,291330,2553371,10038224,8102402,3506903,1782834,75793,1782834,2499952900.0,495800,25460,1512364,3295198,85400,0.0
1251,711724,2355002,12345,524104,2333253,1813707,826704,248936,17114,248936,321315000.0,304500,12990,462788,711724,161800,0.0
1182,623642,2121220,12242,481655,2070914,1614336,711900,254313,16015,254313,307394900.0,280200,10485,369329,623642,126700,0.0
1955,630451,1911226,40662,518813,1902184,1523304,658409,271587,12405,271587,533990400.0,829600,3175,358864,630451,84500,0.0
1863,104846,260814,12429,74585,256100,213034,112606,37550,1304,37550,70755500.0,908800,764,67296,104846,64500,0.0
1398,138564,374985,2042,97422,372281,299851,159667,40411,2787,40411,57892000.0,413300,1965,98153,138564,236600,0.0
829,19018,43530,82,10894,43402,35786,24055,6561,262,6561,5263700.0,176600,388,12457,19018,107400,0.0
966,70486,178919,416,44840,177505,144794,78211,26391,948,26391,26377400.0,233500,947,44095,70486,148300,0.0
1407,147352,434981,5667,113060,422306,347462,155973,58971,3021,58971,83399600.0,342000,1060,88381,147352,103300,0.0
826,9683,27442,47,5873,24226,22188,11364,3687,148,3687,2949000.0,185900,290,5996,9683,72200,0.0
896,7047,21479,27,5082,21299,16168,7990,2526,152,2526,2183900.0,223600,99,4521,7047,206600,0.0
775,9936,27935,39,6469,27636,21374,10962,4212,87,4212,3088100.0,214600,46,5724,9936,123900,0.0
970,86167,225207,901,56254,222635,184969,98119,35323,4500,35323,35697000.0,238200,1231,50844,86167,282600,1.0
918,42349,150183,350,33526,132483,113303,45364,20424,855,20424,18925500.0,185600,536,21925,42349,111900,0.0
840,8287,18724,4,4617,18571,16042,15740,2271,260,2271,1828800.0,228900,365,6016,8287,97200,0.0
1326,105044,280119,1677,73123,273626,235225,120182,41992,1637,41992,57182000.0,499800,1627,63052,105044,141700,0.0
931,301824,971616,4593,229435,960471,721274,326213,141823,7394,141823,135978500.0,220600,2998,160001,301824,143500,0.0
933,264993,878744,2759,199857,850055,648709,293548,113429,7359,113429,110485200.0,190600,4251,151564,264993,142300,0.0
1693,1024976,3155816,32342,809946,3139021,2524230,1081701,436425,18836,436425,749999800.0,620500,9311,588551,1024976,132000,0.0
1643,270046,847834,4689,209601,841387,669012,285997,99368,4046,99368,162299000.0,520300,2368,170678,270046,101400,0.0
1195,17812,45057,159,9532,44675,38241,28169,3881,347,3881,4334200.0,273400,856,13931,17812,356300,1.0
980,32188,95583,269,23893,94357,73233,34204,13831,594,13831,13947300.0,234500,396,18357,32188,105500,0.0
1973,261796,763450,41148,209456,759448,618505,275109,105396,4140,105396,212251500.0,917700,1857,156400,261796,160000,0.0
961,22267,53899,107,12946,50891,46043,31433,6809,447,6809,6316300.0,273500,757,15458,22267,504900,1.0
1100,223808,724153,4302,170306,715502,546782,239253,99074,5635,99074,112500900.0,281100,2838,124734,223808,98200,0.0
1056,14185,37306,16,8007,33587,32280,18259,3264,390,3264,3324600.0,278600,499,10921,14185,164900,0.0
614,1568,3628,0,784,3628,3039,2788,449,65,449,176900.0,114200,17,1119,1568,145900,1.0
1172,162508,487850,9197,136790,484371,366838,169275,57282,3305,57282,67624500.0,241900,1565,105226,162508,86300,0.0
533,2992,8147,1,1784,8109,6163,4381,656,30,656,282000.0,113100,20,2336,2992,665300,1.0
660,2093,4505,0,1035,4492,3872,4394,379,122,379,246600.0,248300,200,1714,2093,944600,1.0
1574,113799,320940,3241,98049,319951,241613,118044,23368,1490,23368,38159800.0,407100,1212,90431,113799,117100,0.0
1370,17765,53726,1792,15712,53658,42899,31912,5256,811,5256,7047300.0,471100,445,12509,17765,123000,0.0
889,3324,7481,63,2676,7426,6389,4686,1410,89,1410,1171500.0,197600,45,1914,3324,95600,0.0
1090,21818,54469,321,16654,54008,45268,27087,6938,757,6938,7688900.0,356700,545,14880,21818,251200,0.0
732,5103,13056,67,3984,12930,10092,6267,1540,318,1540,1201700.0,169200,173,3563,5103,434000,1.0
1241,7340,17747,1582,5869,17692,15294,13574,2583,1051,2583,3404500.0,593600,144,4757,7340,231100,0.0
586,4750,11430,25,3203,11236,9130,6724,1607,89,1607,856700.0,143000,119,3143,4750,120000,0.0
613,776,2127,0,552,2086,1520,921,206,11,206,85700.0,90000,9,570,776,119300,1.0
669,1760,5806,0,1050,3880,4999,2252,659,22,659,371000.0,77700,117,1101,1760,528300,1.0
827,1215,5514,0,863,4246,4874,1587,317,49,317,233800.0,79700,30,898,1215,136300,1.0
826,707,1736,0,444,1736,1382,1422,143,13,143,75800.0,122000,27,564,707,151900,1.0
1069,255,569,0,168,569,491,718,84,70,84,94400.0,269400,26,171,255,101000,0.0
706,597,1372,0,449,1367,1097,1312,177,37,177,63100.0,171300,37,420,597,474800,1.0
1140,130502,330976,2138,102188,328531,271565,142642,45876,1930,45876,53311600.0,306600,1246,84626,130502,478600,1.0
712,8151,21885,15,5865,21357,17771,9067,3099,291,3099,2431600.0,148700,180,5052,8151,121300,0.0
774,10520,25770,7,7221,25595,20547,12245,3135,132,3135,2197600.0,197900,234,7385,10520,199400,0.0
1160,3301,7804,561,2575,7778,6504,6763,1327,449,1327,1739700.0,485000,109,1974,3301,97000,0.0
1057,10076,23769,43,7463,23535,20019,13003,1942,207,1942,2030700.0,261100,421,8134,10076,118100,0.0
705,4053,10109,5,2845,9967,7662,4489,1539,55,1539,895500.0,148800,55,2514,4053,149500,0.0
1334,125026,316782,7812,99770,314665,261334,132801,47211,2469,47211,65575300.0,423500,833,77815,125026,123100,0.0
1029,8866,24553,8,7317,24469,19736,9325,901,23,901,1008100.0,380000,131,7965,8866,386800,0.0
702,6327,14151,22,4153,13582,11856,8532,2158,347,2158,1347700.0,145900,137,4169,6327,112200,0.0
781,1477,5520,0,935,3517,4563,1903,456,65,456,347500.0,132100,11,1021,1477,106500,0.0
810,4374,9257,25,3178,9149,7947,5756,997,9,997,916400.0,317000,28,3377,4374,102000,0.0
1166,9478,24359,437,7503,24223,20454,16598,3007,1542,3007,3443000.0,460600,339,6471,9478,144000,0.0
1343,9455,29722,1162,7475,29644,25507,30652,3168,617,3168,4386900.0,547700,315,6287,9455,121700,0.0
675,6049,16345,0,4103,15903,12743,6867,2606,291,2606,1693800.0,152900,12,3443,6049,218100,1.0
847,12119,30217,7,7014,29167,24779,14724,3511,437,3511,2717600.0,206200,251,8608,12119,115600,0.0
786,16762,46601,35,10655,35935,39920,19630,4206,331,4206,3051500.0,160000,313,12556,16762,146500,0.0
788,63489,163368,659,42945,159796,129896,70618,23383,1397,23383,18588200.0,148000,958,40106,63489,131800,0.0
838,16951,40908,47,10879,40539,32743,18716,5223,331,5223,4138600.0,202500,419,11728,16951,169500,0.0
780,10599,28123,12,8051,27764,21526,11651,3790,306,3790,2842500.0,162900,101,6809,10599,150100,0.0
1098,7389,16900,129,5650,16780,14452,14341,1383,5,1383,1485500.0,262300,196,6006,7389,117600,0.0
633,2626,6338,20,1544,6320,5076,4020,771,66,771,424400.0,150100,93,1855,2626,263700,1.0
907,60562,148798,217,44201,147646,119449,65251,20008,646,20008,18383900.0,207900,825,40554,60562,85900,0.0
677,4913,12084,1,3495,11900,9359,5968,1713,174,1713,1167500.0,94400,102,3200,4913,124700,1.0
700,368,820,0,260,820,704,1439,111,35,111,65600.0,325400,44,257,368,115700,0.0
1070,249745,674826,2581,200254,642935,525197,265305,91774,5153,91774,102429200.0,238200,2589,157971,249745,141900,0.0
678,2012,4809,16,1445,4521,3862,2397,579,34,579,320300.0,120300,65,1433,2012,158300,1.0
1013,5724,14793,235,4500,14734,12526,16515,1777,741,1777,1745200.0,285000,281,3947,5724,85200,0.0
1218,235263,626612,14403,194537,620873,491145,246011,87883,4730,87883,110435800.0,292900,1877,147380,235263,148400,0.0
703,7490,18325,0,4732,18138,14563,8975,2677,403,2677,1753200.0,91800,52,4813,7490,203400,1.0
634,1696,4327,0,1261,4253,3347,1930,544,26,544,311600.0,132600,73,1152,1696,108300,0.0
904,5553,12592,8,3618,12489,10610,9121,1477,261,1477,1395700.0,274000,301,4076,5553,219800,0.0
1131,287262,678467,24466,228655,672437,551538,306714,143388,9075,143388,170103200.0,322900,2174,143874,287262,83100,0.0
619,576,1368,3,382,1343,1047,800,138,31,138,71800.0,83200,24,438,576,130700,1.0
634,3173,6498,18,1656,6348,5517,5210,891,13,891,497800.0,137400,203,2282,3173,97700,0.0
540,1603,3581,0,1098,3479,2946,2257,455,77,455,194600.0,79800,34,1148,1603,251800,1.0
805,7900,18818,22,5206,17649,16260,10630,1809,209,1809,1442300.0,313200,282,6091,7900,229200,0.0
1044,2603,5793,37,2125,5744,4816,3575,530,27,530,562300.0,301700,102,2073,2603,154500,0.0
743,2995,7846,27,2233,7123,6226,3548,902,117,902,552800.0,130200,71,2093,2995,126200,0.0
1169,21055,57945,1127,17447,57305,44622,23735,7146,463,7146,8455600.0,323800,338,13909,21055,90000,0.0
908,6495,16215,279,5258,16170,13689,11766,2683,596,2683,2455400.0,313900,219,3812,6495,287600,0.0
1205,227805,564029,9806,179831,557612,461843,236666,66531,2706,66531,82536600.0,334100,1936,161274,227805,95000,0.0
638,404,834,0,266,834,756,1297,59,21,59,38400.0,279000,30,345,404,121300,0.0
1101,2204,4653,0,1504,4653,4057,3215,674,68,674,704300.0,420600,65,1530,2204,80900,0.0
731,2417,6557,17,1828,6445,5133,3372,750,237,750,536400.0,201000,90,1667,2417,144000,0.0
534,998,2357,8,653,2327,1897,1297,288,57,288,168600.0,91500,28,710,998,119200,1.0
955,99817,285729,760,81011,283372,217015,104147,28366,1391,28366,27234000.0,245000,889,71451,99817,88400,0.0
1100,327402,862127,16823,243012,851682,706271,365546,123365,12895,123365,133767700.0,244400,5477,204037,327402,180400,0.0
995,74605,184454,1311,55646,183145,153976,88068,17275,957,17275,16932600.0,250100,1418,57330,74605,154500,0.0
1044,348871,897417,14321,263308,883429,729072,377840,123493,11043,123493,125041900.0,235300,5292,225378,348871,169900,0.0
869,44529,116674,291,33605,114975,95788,49577,13387,1110,13387,11352700.0,196800,699,31142,44529,212300,1.0
1071,107193,270772,1999,81999,258628,222909,122599,35746,2409,35746,37376400.0,238900,2243,71447,107193,120800,0.0
1132,66599,164110,1361,50551,162181,137456,75938,17511,1674,17511,18898000.0,283700,1624,49088,66599,111400,0.0
1093,54878,151596,1287,43531,148725,127926,59099,15168,1310,15168,16734200.0,247500,741,39710,54878,128600,0.0
1439,337678,947328,47981,263020,938998,754693,369044,109012,7958,109012,159859300.0,417800,6504,228666,337678,85000,0.0
1059,60607,166778,49,44816,157339,133938,69166,15571,1887,15571,15897100.0,170500,1258,45036,60607,210300,1.0
1490,25938,64283,1229,21355,63952,50529,26909,8631,462,8631,12617300.0,356500,92,17307,25938,165900,0.0
1104,202654,555036,10437,157390,546567,447504,221003,64036,6795,64036,70662200.0,248100,4076,138618,202654,132500,0.0
992,86322,215551,658,57685,212852,178417,132980,17974,1505,17974,16153000.0,242900,2318,68348,86322,136500,0.0
1030,63381,173145,880,47661,169720,136783,69506,19249,1181,19249,19249200.0,205800,1403,44132,63381,162400,0.0
1057,140255,363542,1128,85940,360684,302121,183774,40155,6269,40155,44389100.0,197200,4586,100100,140255,192300,0.0
778,62488,141373,71,30268,139310,122938,78825,11932,1294,11932,9311800.0,117400,2274,50556,62488,210200,1.0
691,15806,39713,5,9175,39408,32461,20327,3958,420,3958,2275400.0,88700,360,11848,15806,74600,0.0
755,8299,27537,0,5974,25058,21516,9838,1860,84,1860,1146600.0,121100,127,6439,8299,134100,1.0
972,209885,518660,2114,130458,513218,436792,258019,64186,5508,64186,62797100.0,149900,5861,145699,209885,265800,1.0
968,112373,285890,2197,89924,282509,238314,127813,53232,5330,53232,53487500.0,187400,1658,59141,112373,149800,0.0
1271,675828,1890416,25095,514737,1878890,1531882,818382,255048,26539,255048,339816800.0,223400,16659,420780,675828,265900,1.0
654,6743,18518,0,3882,16500,15366,8571,1637,349,1637,867800.0,87200,198,5106,6743,113900,1.0
1507,30198,76745,722,20945,74716,66559,53378,12474,4029,12474,18633900.0,429000,1125,17724,30198,156800,0.0
928,117836,309924,821,84578,294389,251993,139751,46045,7826,46045,41994900.0,126700,1756,71791,117836,88700,0.0
933,72234,179144,112,40812,177193,149770,85726,16047,1551,16047,14351300.0,120600,2267,56187,72234,117100,0.0
1040,505845,1351087,9110,391032,1339107,1074256,563638,212702,18261,212702,228482000.0,179500,9040,293143,505845,199900,1.0
1060,76574,197591,245,57100,185509,157905,95651,28112,2222,28112,29884700.0,198700,1082,48462,76574,152500,0.0
621,7406,22350,0,4898,18413,18551,11047,1537,461,1537,700500.0,84900,315,5869,7406,128300,1.0
840,11075,31586,0,8420,28013,25878,13185,2172,142,2172,1585400.0,133700,384,8903,11075,95700,0.0
699,8558,24472,5,5259,22045,20202,10839,1809,154,1809,1026500.0,102700,235,6749,8558,114800,1.0
991,347783,912043,7836,266274,892880,726124,399736,147116,16179,147116,146540400.0,156200,9407,200667,347783,160800,0.0
755,8980,26775,6,5834,23490,21920,11021,2599,61,2599,1756800.0,90500,183,6381,8980,153900,1.0
971,227223,568183,1360,147620,563561,475860,274602,63658,10110,63658,63254300.0,162400,4296,163565,227223,292500,1.0
1088,71939,203291,99,55362,200260,160699,78815,18411,840,18411,19421400.0,165300,1201,53528,71939,88800,0.0
645,2193,8684,4,1311,7127,7126,3226,412,105,412,228300.0,101400,82,1781,2193,125800,1.0
979,127441,326215,330,79371,322861,269018,151295,33797,3314,33797,34124000.0,155100,4044,93644,127441,150600,0.0
1084,30454,78435,30,21018,77522,64591,37177,6766,575,6766,7374600.0,203500,608,23688,30454,116400,0.0
1007,406871,949842,7226,267326,938695,808886,506468,141243,14097,141243,148215100.0,167100,12701,265628,406871,109100,0.0
913,226604,652256,1286,151317,643984,521280,288797,71901,6764,71901,65798600.0,121100,6493,154703,226604,172700,1.0
1088,110043,298763,563,70009,296498,244813,138923,30563,4230,30563,32430000.0,150700,2911,79480,110043,87000,0.0
729,4297,13197,6,2054,11921,11187,6985,1074,147,1074,755000.0,80100,211,3223,4297,209300,1.0
746,12098,39064,757,8757,38293,29594,14670,4183,201,4183,2745700.0,79700,199,7915,12098,138300,1.0
928,57911,147981,129,32483,146713,125409,78469,13997,4330,13997,13864800.0,172600,2130,43914,57911,233700,1.0
650,17041,48571,8,10414,40961,40587,21060,5099,427,5099,2767300.0,94900,244,11942,17041,121900,1.0
1264,543591,1426772,11982,364697,1414266,1181503,678673,170914,18613,170914,222240100.0,242500,14996,372677,543591,84500,0.0
1207,83744,226578,88,61312,224907,182905,100322,19239,1863,19239,23396500.0,274600,1525,64505,83744,86100,0.0
1143,161371,449260,1763,125498,446400,364534,186869,55255,7944,55255,63994400.0,201900,3141,106116,161371,147800,0.0
1195,858289,2702602,64634,646001,2676045,2213272,1008908,410278,34654,410278,503273800.0,242800,15343,448011,858289,114500,0.0
966,68667,180117,917,50033,175626,145705,101437,25786,10763,25786,25273700.0,166400,1535,42881,68667,167900,0.0
1118,39433,105015,98,21995,104651,88729,50279,9064,412,9064,9705500.0,188400,1087,30369,39433,256000,1.0
719,4327,11675,17,2598,10009,9942,8645,1145,482,1145,754800.0,135300,164,3182,4327,181600,1.0
908,5295,16018,0,3412,13612,13839,9372,1342,362,1342,1070200.0,151400,421,3953,5295,104900,0.0
576,4551,14238,7,2826,10897,11831,5795,1197,246,1197,584700.0,73500,98,3354,4551,98600,1.0
578,2325,8347,136,1512,6919,7059,3522,574,104,574,254400.0,62400,64,1751,2325,77700,1.0
1129,96250,325168,1850,75300,323420,253747,139796,38110,3485,38110,42843700.0,164500,2405,58140,96250,89700,0.0
831,52360,116754,55,16920,107584,109138,66983,5167,1715,5167,4514300.0,239800,2130,47193,52360,78300,0.0
936,25449,63457,48,17218,61322,51774,49446,7328,2781,7328,6801600.0,203100,483,18121,25449,111000,0.0
684,17310,46113,0,11105,43233,36811,19680,5151,344,5151,2899800.0,101300,173,12159,17310,103200,0.0
656,7019,19483,15,4069,17661,16053,8671,1523,153,1523,728100.0,92400,85,5496,7019,199800,1.0
809,5702,14085,0,3900,11547,12059,6680,1288,117,1288,687700.0,131700,72,4414,5702,211500,1.0
1035,264325,700165,2106,159449,694456,586049,383224,79758,9340,79758,86097300.0,190200,7526,184567,264325,189100,0.0
839,134747,343778,473,73679,335286,286877,166357,33233,4487,33233,25916400.0,119200,4211,101514,134747,101700,0.0
675,7718,27326,301,5274,25591,20817,9724,2430,268,2430,1478200.0,81200,284,5288,7718,76600,0.0
1178,138131,356774,3331,82808,354838,300135,207403,38507,5217,38507,47068600.0,316200,4303,99624,138131,85200,0.0
726,13333,40228,31,7958,37383,32646,18598,3703,416,3703,2467000.0,89900,395,9630,13333,124300,1.0
1109,451960,1290216,16732,366802,1278710,1030605,517631,205585,23970,205585,232981300.0,192400,10065,246375,451960,81400,0.0
916,97485,259865,4573,72976,257247,218222,115282,45233,7602,45233,42711800.0,167000,1816,52252,97485,85600,0.0
1424,277985,672391,123684,216857,661858,564615,308161,162190,12279,162190,244260000.0,537400,3581,115795,277985,148800,0.0
971,195818,498136,753,124249,492284,408742,237481,54991,5165,54991,54434200.0,134300,6131,140827,195818,149400,1.0
632,6399,17191,49,4056,15895,14247,7436,1170,84,1170,687600.0,96700,109,5229,6399,118800,1.0
745,41350,100177,744,20232,99076,84633,55502,10466,1714,10466,7392600.0,87900,1627,30884,41350,83500,0.0
702,15291,43814,0,9669,42328,35502,19214,4471,318,4471,2425100.0,92400,374,10820,15291,193300,1.0
672,11744,35675,654,6631,33928,29346,14999,3654,453,3654,2355100.0,83700,292,8090,11744,211900,1.0
607,4581,14458,0,2778,12431,11682,6007,757,124,757,374600.0,80000,186,3824,4581,175200,1.0
936,74884,173236,87,37457,169791,153842,102657,16312,2845,16312,15830900.0,165200,2605,58572,74884,163000,0.0
797,24722,68484,31,16340,63751,55304,28806,6671,740,6671,4843400.0,112500,639,18051,24722,114800,0.0
661,6431,16323,0,3537,14786,13636,9369,1400,81,1400,694600.0,71600,250,5031,6431,123200,1.0
1043,63497,155719,137,37398,152694,132951,79523,14855,1752,14855,15958600.0,233000,1291,48642,63497,83000,0.0
679,27951,72435,111,15798,71289,58455,37251,7630,456,7630,4456600.0,82800,1082,20321,27951,149300,1.0
1116,177998,404839,1129,96699,401034,352490,234414,47299,5902,47299,55562900.0,215300,4086,130699,177998,120000,0.0
616,3946,15300,44,2798,9967,12768,4554,1273,70,1273,693500.0,89000,41,2673,3946,84300,0.0
403,1154,3024,5,551,2968,2381,1968,407,0,407,107900.0,59900,39,747,1154,74100,1.0
670,1502,4011,6,1064,4011,2999,1727,570,40,570,353700.0,57000,29,932,1502,146100,1.0
846,33200,83467,127,23435,82462,66526,42299,12849,1567,12849,10837900.0,161200,631,20351,33200,159300,0.0
1062,273614,736066,27708,221866,730052,579964,307776,125704,11534,125704,137662200.0,176000,4457,147910,273614,127800,0.0
666,11033,28722,0,7456,28388,22587,12382,3498,143,3498,2156100.0,117000,195,7535,11033,105400,0.0
707,3438,7768,5,2239,7689,6469,4857,942,61,942,509200.0,115600,57,2496,3438,89500,0.0
798,21785,63851,48,15929,63273,49205,24441,5005,608,5005,3901500.0,163200,470,16780,21785,238100,1.0
536,5797,15954,0,3650,15477,12549,7279,2071,191,2071,1026400.0,69200,97,3726,5797,106200,1.0
803,10472,28540,50,7537,28202,22614,11777,2035,118,2035,1545200.0,124800,42,8437,10472,120800,0.0
670,14176,39444,25,10400,39245,30582,16028,4556,342,4556,2790000.0,91700,134,9620,14176,122000,1.0
856,73179,198647,1166,53284,187695,154647,84150,37724,4465,37724,33427900.0,140200,1172,35455,73179,100200,0.0
661,3893,11396,0,2548,9855,9849,4797,1509,153,1509,919900.0,111100,28,2384,3893,189700,1.0
667,6506,16354,32,3520,16141,13918,12568,1682,302,1682,887800.0,157800,437,4824,6506,196500,1.0
515,1780,5832,0,1007,3965,5123,2355,569,18,569,244100.0,51800,0,1211,1780,126200,1.0
689,4588,11173,0,2154,10996,9879,8055,880,151,880,567000.0,197900,130,3708,4588,94300,0.0
573,2633,6752,0,1631,6404,5440,3340,763,58,763,332400.0,71000,87,1870,2633,168200,1.0
548,3103,8036,3,2122,7685,6292,3901,934,137,934,568100.0,72700,147,2169,3103,165800,1.0
516,3323,9278,0,1994,8996,7491,4060,816,0,816,341300.0,81200,39,2507,3323,97500,1.0
485,2835,8313,0,2173,8288,6164,3502,735,90,735,298200.0,62500,57,2100,2835,96500,1.0
534,6702,18471,15,4550,18020,14387,8536,1886,216,1886,789100.0,72100,23,4816,6702,145700,1.0
528,3989,11279,52,2599,10637,8625,4806,1168,93,1168,618300.0,73200,34,2821,3989,115800,1.0
579,6658,18411,87,3890,18354,14385,8112,1446,52,1446,742100.0,68200,92,5212,6658,165900,1.0
695,35384,103963,11,26843,103153,79496,39851,13549,1290,13549,9106900.0,124300,564,21835,35384,89800,0.0
543,1865,6503,10,1256,4642,5456,2404,608,47,608,207700.0,49000,25,1257,1865,147900,1.0
562,4618,13675,4,2977,11784,11358,6104,1683,135,1683,782400.0,61300,137,2935,4618,105600,1.0
792,24679,69433,61,17559,68018,53875,28380,10605,891,10605,7875000.0,125000,350,14074,24679,90600,0.0
774,57319,153923,568,39092,150403,120059,70248,27084,4017,27084,20043500.0,117300,1228,30235,57319,139900,1.0
909,12088,33198,94,9033,32677,26773,13881,1848,49,1848,1557500.0,194800,103,10240,12088,173600,0.0
554,3263,8558,39,2123,8458,6896,4185,897,78,897,406100.0,86300,53,2366,3263,117700,1.0
704,1925,5168,0,1339,5168,4035,2196,657,34,657,347200.0,94800,10,1268,1925,121900,1.0
668,7899,20809,0,5285,20647,16519,9316,2556,220,2556,1504700.0,85600,155,5343,7899,90000,1.0
580,4155,12779,4,2595,12424,10417,5315,1177,117,1177,542100.0,98800,103,2978,4155,151600,1.0
509,5171,14053,0,3338,12259,11829,6263,1846,120,1846,853800.0,83200,66,3325,5171,125300,1.0
630,4023,10757,11,2784,10236,8137,4718,1425,101,1425,826200.0,83600,39,2598,4023,112700,1.0
638,8322,22328,31,5252,22121,18034,10578,2699,311,2699,1519500.0,101600,149,5623,8322,157800,1.0
571,1091,2627,0,763,2622,2101,1446,240,15,240,94800.0,57200,0,851,1091,129100,1.0
957,19584,57087,45,15924,56487,43397,21508,4556,282,4556,4075100.0,155500,257,15028,19584,140700,0.0
646,6263,18282,0,3745,18042,15005,7558,1924,329,1924,1282000.0,132400,99,4339,6263,113100,0.0
521,1083,3027,0,737,2939,2411,1518,228,50,228,104000.0,66600,0,855,1083,139100,1.0
569,8387,22502,90,5577,21788,17387,9939,2668,150,2668,1312200.0,78500,31,5719,8387,90800,1.0
697,978,2140,0,483,2140,1803,2073,253,53,253,122100.0,67400,140,725,978,285200,1.0
993,107427,285506,3342,82082,277596,228961,123555,49512,5126,49512,48615100.0,177900,1922,57915,107427,174400,0.0
1014,23108,62120,129,18756,56244,45883,27696,12752,1842,12752,12117700.0,120500,503,10356,23108,173100,1.0
811,5100,13732,6,3477,13640,10750,6347,1353,98,1353,886900.0,119700,310,3747,5100,97700,0.0
525,3277,9800,0,2144,9553,8034,4120,967,56,967,400400.0,64200,91,2310,3277,194400,1.0
681,3744,10388,0,2316,9812,7983,4384,1438,202,1438,909600.0,102000,10,2306,3744,93400,0.0
716,10571,28600,21,7379,28410,22724,11933,2738,135,2738,1687100.0,121600,130,7833,10571,225600,1.0
614,7991,22574,6,5380,20373,17801,9036,2724,87,2724,1409400.0,82500,151,5267,7991,182100,1.0
712,3353,8549,26,1903,8448,6949,4830,973,163,973,582500.0,77200,184,2380,3353,209800,1.0
607,14999,40531,39,10839,40137,31398,16608,6454,0,6454,4060400.0,112200,31,8545,14999,105700,0.0
537,2943,8323,32,1529,8241,6871,4243,632,5,632,257800.0,57000,49,2311,2943,74100,1.0
690,14949,41444,41,10406,41217,32032,16988,5303,402,5303,3274400.0,105600,249,9646,14949,197600,1.0
659,2801,6423,2,1747,6405,5479,3408,539,20,539,218300.0,81200,44,2262,2801,94900,1.0
576,3554,8267,8,2272,8100,6775,4578,1083,46,1083,516800.0,65800,57,2471,3554,219400,1.0
636,3290,8978,12,2106,8659,7108,4177,1365,129,1365,741100.0,88600,11,1925,3290,100800,1.0
808,17254,44909,6,11867,44220,35204,20546,6138,488,6138,4370700.0,131400,399,11116,17254,101800,0.0
567,10521,27160,47,7132,26883,20663,12178,4150,341,4150,2192000.0,97500,246,6371,10521,149300,1.0
616,3288,9147,4,2029,9058,7253,4473,770,12,770,358000.0,69100,46,2518,3288,157000,1.0
630,6361,17272,0,4265,16949,13378,7948,2500,51,2500,1466700.0,81200,45,3861,6361,177800,1.0
581,8068,22645,15,5585,22413,17353,9961,2481,208,2481,1285600.0,86500,165,5587,8068,167600,1.0
777,24719,65870,0,18277,65387,52304,27115,6579,294,6579,4812000.0,138800,534,18140,24719,85600,0.0
1267,2505,11096,0,2064,6395,8736,3349,1830,560,1830,2107100.0,81700,0,675,2505,152400,1.0
594,9253,24880,40,5735,23173,20037,10961,3176,317,3176,1650600.0,68500,225,6077,9253,179500,1.0
1117,45823,143723,52,36762,139660,111009,54941,9831,1851,9831,11004300.0,183800,2223,35992,45823,150700,0.0
622,10311,27023,53,6346,25776,21055,12200,4154,359,4154,2427500.0,109800,59,6157,10311,152000,1.0
711,35506,96471,148,25357,94340,76229,40461,14135,1557,14135,9967100.0,126600,691,21371,35506,218800,1.0
1249,70468,211300,462,58672,210703,157855,74692,11089,616,11089,13909000.0,301100,1035,59379,70468,176000,0.0
733,15106,43878,105,9692,41951,35107,18328,3745,512,3745,2564200.0,137200,693,11361,15106,94300,0.0
666,9848,25535,20,6190,24722,20720,13072,2491,213,2491,1467200.0,131200,132,7357,9848,111500,0.0
760,40318,113941,152,29500,108833,89366,46358,19283,2034,19283,14423400.0,129700,922,21035,40318,157200,1.0
754,5730,14061,0,3539,13941,11902,9492,1217,19,1217,864500.0,112700,303,4513,5730,277400,1.0
749,8108,21152,31,5397,21038,17039,9980,2575,109,2575,1567500.0,91300,123,5533,8108,166200,1.0
692,9590,26795,52,6554,25647,22028,10971,2192,170,2192,1404800.0,159900,59,7398,9590,152600,0.0
693,8662,21430,22,5866,21260,17539,12979,2172,323,2172,1430100.0,168700,631,6490,8662,106300,0.0
674,11871,30687,3,7952,29786,24211,13888,5245,415,5245,3353100.0,82600,210,6626,11871,113600,1.0
520,710,1844,0,410,1844,1590,1091,215,40,215,115600.0,59100,3,495,710,165200,1.0
548,2274,5410,4,1345,5336,4397,2973,748,24,748,392700.0,62300,0,1526,2274,196500,1.0
485,1321,3251,0,794,3251,2679,1770,405,39,405,133600.0,79500,42,916,1321,158500,1.0
1229,12366,34883,0,10001,33781,25993,13430,3851,194,3851,4637200.0,201700,259,8515,12366,174400,0.0
796,8053,23556,0,5759,20914,19155,9357,2425,253,2425,1739500.0,121500,434,5628,8053,88500,0.0
577,4061,10894,2,2770,10621,8450,4752,1688,113,1688,964300.0,88600,0,2373,4061,113300,1.0
957,18913,52252,40,14817,48460,40630,21687,7555,968,7555,7256800.0,154500,263,11358,18913,168400,1.0
820,41123,114898,135,30268,113725,90364,45097,14768,1001,14768,11343500.0,119600,566,26355,41123,170400,1.0
706,4715,12385,27,3142,12233,10059,5340,1093,19,1093,546000.0,93300,12,3622,4715,137100,1.0
627,4032,10405,5,2388,10255,8184,4970,1285,147,1285,719800.0,82700,3,2747,4032,151000,1.0
624,8312,23005,26,5205,22589,17945,10781,3403,500,3403,1900900.0,83900,208,4909,8312,82000,0.0
575,14329,43048,6,9561,39620,33664,17184,4861,420,4861,2519000.0,87600,119,9468,14329,187600,1.0
986,50531,138015,411,40099,137378,107040,52929,13859,569,13859,13730300.0,190700,395,36672,50531,260300,1.0
1102,274361,739072,4081,228134,734497,578844,295227,97845,7639,97845,110695500.0,219700,4448,176516,274361,135800,0.0
709,11468,29614,24,7170,29413,24417,16890,2931,757,2931,2054800.0,162400,355,8537,11468,114600,0.0
665,6089,16282,14,4180,16085,13585,7332,1505,95,1505,873300.0,122500,147,4584,6089,123800,0.0
926,30488,88695,31,23406,87884,68621,33041,8245,642,8245,7236800.0,164700,375,22243,30488,189500,1.0
639,3971,9905,6,2418,9809,8141,5171,1282,66,1282,676200.0,83400,52,2689,3971,186000,1.0
647,6337,15629,26,4112,15564,12656,7767,1676,205,1676,971800.0,92400,93,4661,6337,114900,1.0
538,7858,21063,30,4979,19187,17251,9822,2658,140,2658,1040200.0,73400,68,5200,7858,120500,1.0
676,19959,56424,134,14816,55913,44061,22391,7141,539,7141,4843600.0,119500,478,12818,19959,157400,1.0
583,7730,19288,12,4597,19061,15591,9593,2150,147,2150,1162000.0,81800,177,5580,7730,199500,1.0
1138,83150,235896,567,68057,234834,182166,87941,19601,1100,19601,22236400.0,220200,1603,63549,83150,123700,0.0
1202,39604,110306,459,30629,109570,88057,41747,7527,455,7527,9202500.0,255300,543,32077,39604,166700,0.0
528,3375,8929,0,2223,8852,7024,4565,1058,130,1058,480300.0,59100,55,2317,3375,111400,1.0
855,10292,29216,0,8310,28257,22336,10877,2746,153,2746,2414200.0,156800,106,7546,10292,157900,0.0
936,35823,105042,265,27571,104152,80489,38713,11094,439,11094,10480200.0,123300,563,24729,35823,165000,1.0
882,11379,30343,59,7730,30107,24735,13844,2554,354,2554,2008100.0,185700,352,8825,11379,154100,0.0
679,6793,16732,23,4040,16566,13813,9282,1892,250,1892,1381900.0,175800,199,4901,6793,103100,0.0
624,15599,45890,156,11218,45329,34858,18510,6322,628,6322,4021600.0,84500,434,9277,15599,56100,0.0
703,6065,17190,9,4202,17079,13308,7354,1880,98,1880,1218700.0,87800,23,4185,6065,75500,0.0
874,8557,23397,14,6320,23182,19070,10914,1730,84,1730,1482700.0,202300,298,6827,8557,67700,0.0
795,2970,8667,21,1671,6021,7485,5360,639,165,639,381400.0,66100,128,2331,2970,85300,1.0
921,91604,274150,3058,74609,270576,205046,105058,45384,7685,45384,41901400.0,89400,1211,46220,91604,84000,0.0
1089,391850,1010420,36032,309681,1001021,804909,456265,190705,21364,190705,212524800.0,268900,8211,201145,391850,188900,0.0
893,63095,192865,224,49194,191800,148088,70877,20523,1363,20523,18613200.0,171900,1008,42572,63095,31400,0.0
848,11412,31567,22,7934,31283,26488,13314,4091,185,4091,3121000.0,176300,213,7321,11412,130700,0.0
625,8156,21488,0,5553,21098,16473,9331,3148,217,3148,1929200.0,102500,207,5008,8156,116300,1.0
665,2326,5884,32,1428,5722,4694,2763,791,85,791,430900.0,88500,11,1535,2326,117700,1.0
839,6698,18013,9,4864,17838,14327,7606,1695,46,1695,1207100.0,208200,40,5003,6698,121100,0.0
642,4379,11607,14,2987,11458,9213,5181,1333,110,1333,813200.0,100500,107,3046,4379,162700,1.0
911,12693,35972,0,10144,35778,27619,13491,2261,149,2261,2148600.0,252000,118,10432,12693,103000,0.0
701,34842,91522,730,24235,89580,71427,40702,19114,2571,19114,13487500.0,102100,597,15728,34842,97900,0.0
738,10175,24480,14,5480,24327,20750,16843,2358,808,2358,1424800.0,171500,476,7817,10175,69800,0.0
1111,72697,217506,933,58848,216285,167117,78971,20360,1901,20360,22515900.0,154900,1322,52337,72697,64700,0.0
882,55200,150341,24,42228,146927,115466,61493,19804,1657,19804,17377500.0,135800,648,35396,55200,48500,0.0
608,17437,47451,32,10965,46458,36880,21470,6481,328,6481,3671100.0,85000,154,10956,17437,115000,1.0
759,5399,17857,7,4177,17064,13073,6541,1691,452,1691,1241200.0,117500,120,3708,5399,111100,0.0
818,23475,64192,97,15981,63180,50215,27178,9071,955,9071,7240300.0,112400,1180,14404,23475,45200,0.0
638,9427,25625,0,6010,25619,20541,12624,2807,364,2807,1723800.0,98500,310,6620,9427,98800,0.0
540,5167,16339,0,3089,13035,13748,7254,1976,311,1976,824500.0,55600,81,3191,5167,128900,1.0
685,8788,22262,0,4532,21757,19024,14414,1747,315,1747,1022600.0,191800,410,7041,8788,127000,0.0
615,10263,26241,40,6476,25695,21092,12147,3663,171,3663,2124000.0,84900,314,6600,10263,38100,0.0
656,7384,20506,54,5013,18795,16394,9173,2304,270,2304,1308000.0,82400,133,5080,7384,70000,0.0
751,11250,28509,18,7110,28317,23383,16160,3023,630,3023,2116300.0,157900,620,8227,11250,65400,0.0
715,10113,27027,68,7067,26928,21826,11435,3474,377,3474,2478100.0,126000,179,6639,10113,155600,1.0
1074,51397,152399,353,42438,151710,115598,54395,11458,494,11458,12197700.0,150400,1001,39939,51397,76100,0.0
625,6975,19141,0,4580,18993,14876,8092,1852,39,1852,958900.0,99000,72,5123,6975,112900,1.0
753,5963,17919,0,4286,17671,14253,6878,995,114,995,745700.0,162000,171,4968,5963,119900,0.0
813,72361,201568,683,52007,191995,159145,87732,33927,4447,33927,26906600.0,100200,2249,38434,72361,66800,0.0
594,5268,14037,0,3442,13645,11323,6736,1625,182,1625,794500.0,78900,110,3643,5268,223900,1.0
543,8044,25402,10,5705,19121,20774,9979,2557,319,2557,1191700.0,88100,233,5487,8044,82800,0.0
602,7240,19014,10,4578,18757,15041,8759,2223,62,2223,1187500.0,86700,29,5017,7240,137700,1.0
702,25564,68609,33,17618,67252,55155,30276,7089,819,7089,4608200.0,111100,877,18475,25564,81900,0.0
1142,283256,889954,5050,242537,884817,672871,302157,94727,7919,94727,109752700.0,185200,4494,188529,283256,88200,0.0
941,24588,75099,94,19581,74958,57012,27464,6658,553,6658,5925900.0,134300,595,17930,24588,56800,0.0
551,3537,12963,8,2320,11868,10623,4494,971,123,971,439500.0,82200,28,2566,3537,57800,0.0
483,2576,6788,0,1503,6688,5152,3003,736,40,736,275800.0,63100,89,1840,2576,60100,0.0
863,37120,102623,368,28521,101698,80180,40380,12827,468,12827,10671400.0,140500,677,24293,37120,49800,0.0
1014,48426,140152,507,39251,138979,107566,52184,16542,1194,16542,17112500.0,140100,761,31884,48426,235700,1.0
748,9092,25048,0,6154,24860,19299,10809,3544,129,3544,2548000.0,110500,149,5548,9092,104600,0.0
535,5210,14999,3,3483,14911,11255,6499,1390,174,1390,612000.0,77900,132,3820,5210,72800,0.0
573,3077,8962,2,2100,8536,7241,3953,816,88,816,387000.0,76500,99,2261,3077,91800,1.0
693,5642,14654,10,3867,14503,11799,6596,1255,46,1255,747800.0,111800,145,4387,5642,185100,1.0
564,2864,7206,0,1647,7090,5607,3694,1132,13,1132,464500.0,67300,19,1732,2864,81600,1.0
955,29937,88482,617,23190,87695,68711,33421,9417,1587,9417,9064000.0,148600,584,20520,29937,132100,0.0
648,13903,35688,210,9083,33350,28197,16552,5126,316,5126,2867300.0,78500,256,8777,13903,85400,1.0
609,10362,29833,26,6539,27735,23287,12229,3825,166,3825,2058300.0,107300,202,6537,10362,85800,0.0
477,1972,7952,0,965,6121,6764,2619,713,54,713,244100.0,46800,9,1259,1972,113300,1.0
525,2676,8896,11,1499,6829,7349,3520,720,59,720,276100.0,69800,9,1956,2676,134300,1.0
687,16330,45527,54,11089,43600,37731,20459,7326,668,7326,4951900.0,108800,170,9004,16330,39700,0.0
710,6489,18363,0,4448,18359,14591,7659,1673,125,1673,972200.0,128900,115,4816,6489,153500,1.0
787,26632,73742,240,20664,72880,60450,30458,12475,1532,12475,10124500.0,131200,408,14157,26632,79900,0.0
816,46291,123554,2107,35611,122682,104232,52305,28459,2692,28459,24506900.0,154600,630,17832,46291,120000,0.0
1131,67054,196325,929,44939,194927,157779,86348,22112,3119,22112,22587100.0,316000,2213,44942,67054,93100,0.0
1653,311451,990060,41392,248916,941301,799878,346374,138209,9138,138209,235080400.0,626400,2076,173242,311451,110100,0.0
1336,54381,164094,2110,41389,162735,131136,72093,22158,7971,22158,29142700.0,569100,499,32223,54381,112700,0.0
1308,22563,71093,260,16398,70326,57037,30633,8350,1932,8350,10370200.0,520100,406,14213,22563,98300,0.0
867,53,86,0,42,77,84,95,51,8,51,27900.0,-666666666,0,2,53,145600,1.0
730,1581,4284,0,1030,4253,3193,1967,338,15,338,152100.0,151600,40,1243,1581,262200,1.0
628,7827,23472,58,5912,23123,16590,8619,2372,205,2372,1210000.0,136900,52,5455,7827,190000,1.0
740,6404,16850,0,3995,16717,13499,7224,1616,119,1616,1069700.0,148800,250,4788,6404,238000,1.0
789,1609,5296,27,1217,5248,3806,1994,494,102,494,264300.0,127200,36,1115,1609,192200,1.0
803,3532,10104,14,2133,10026,8420,12097,859,33,859,602500.0,258000,218,2673,3532,388900,1.0
604,1736,3946,0,999,3919,3359,2672,350,42,350,187800.0,166500,33,1386,1736,189900,1.0
683,4286,13120,34,3352,13083,9203,4726,837,0,837,530800.0,168200,35,3449,4286,201400,1.0
693,16308,40014,45,11390,39392,32375,17686,4753,467,4753,3244700.0,172500,247,11555,16308,156700,0.0
735,7741,23039,59,5922,22919,16526,8397,2778,126,2778,1843000.0,144400,152,4963,7741,197800,1.0
902,58873,150128,207,41662,148871,118783,67941,17144,842,17144,15497100.0,212900,956,41729,58873,183400,0.0
596,1626,3824,2,995,3780,3042,1909,425,31,425,221400.0,120000,34,1201,1626,133200,1.0
622,7357,20448,10,5597,20371,15142,7942,2130,131,2130,1145000.0,121800,83,5227,7357,281800,1.0
754,30096,82248,90,23380,81298,61787,32465,9635,482,9635,7265800.0,154200,414,20461,30096,191900,1.0
624,4190,11384,19,2929,11256,8711,4857,1325,51,1325,576700.0,125700,61,2865,4190,211300,1.0
984,8273,21583,94,5921,21557,17228,15287,2745,304,2745,2580700.0,390300,396,5528,8273,265900,0.0
750,3004,6968,10,1844,6944,5919,5441,514,50,514,305700.0,185100,124,2490,3004,176600,0.0
642,4490,11323,0,2487,11245,9034,5359,1173,30,1173,761600.0,181300,84,3317,4490,136100,0.0
596,1049,2613,16,676,2572,2140,1338,179,65,179,94300.0,110700,75,870,1049,139500,1.0
563,2533,6862,0,1818,6793,5052,3268,409,68,409,184300.0,130600,36,2124,2533,359300,1.0
689,5550,15110,4,4019,15024,11439,6169,1786,42,1786,1045900.0,134400,62,3764,5550,218400,1.0
910,164389,435117,949,126644,428436,339996,172399,52151,2264,52151,48878000.0,219900,2887,112238,164389,179900,0.0
659,30790,84113,554,23114,82996,64109,33870,9590,790,9590,6419400.0,148300,643,21200,30790,203200,1.0
583,2313,5942,8,1589,5904,4524,4045,496,14,496,247000.0,142100,108,1817,2313,176600,1.0
652,14903,45369,383,11217,45076,32419,16513,3756,334,3756,2386600.0,147400,357,11147,14903,162200,1.0
759,38400,110404,1357,29952,109149,79518,41593,11280,1140,11280,9232600.0,161000,569,27120,38400,270800,1.0
573,370,886,0,217,886,685,810,98,11,98,40600.0,173300,5,272,370,191700,1.0
812,69303,207027,193,51944,205466,152326,73265,22469,1079,22469,17446200.0,144000,1356,46834,69303,288200,1.0
695,3706,8533,4,2171,7535,7317,4555,858,50,858,545700.0,134400,71,2848,3706,228000,1.0
778,8470,27410,279,7027,27376,19011,9105,1609,131,1609,1063600.0,166200,276,6861,8470,216800,1.0
675,15448,38697,113,12330,38531,32324,16626,7218,303,7218,5211000.0,207200,171,8230,15448,168200,0.0
624,1850,4141,15,1214,4115,3635,3196,440,107,440,174200.0,173300,94,1410,1850,95300,0.0
616,3703,7755,0,2207,7680,6558,4828,1092,126,1092,504900.0,173400,196,2611,3703,212500,1.0
714,8571,22839,12,6124,22694,17312,9263,2229,94,2229,1536800.0,138900,139,6342,8571,241900,1.0
693,3508,9050,23,2345,8966,7246,4706,912,30,912,557600.0,150800,243,2596,3508,222600,1.0
752,17563,41855,82,11040,41541,34439,24935,4781,248,4781,3854500.0,222700,414,12782,17563,757300,1.0
575,313,1055,0,253,1055,741,553,140,0,140,33900.0,98700,41,173,313,281500,1.0
777,10062,26232,38,7683,23957,19998,12394,4239,345,4239,3105600.0,145200,165,5823,10062,325000,1.0
738,4383,12889,51,3149,12337,9779,8813,874,231,874,641200.0,157700,185,3509,4383,126300,0.0
673,10633,38241,85,9282,38032,28805,13292,5703,2294,5703,4105900.0,190500,100,4930,10633,167600,0.0
661,5614,12490,13,3593,12327,10366,7096,1681,179,1681,1047400.0,117500,227,3933,5614,133200,1.0
678,6480,16275,29,3872,15648,13448,8757,1356,108,1356,754100.0,164600,242,5124,6480,176800,1.0
906,3764,10776,52,3081,10776,8079,5610,1022,273,1022,867900.0,291600,201,2742,3764,199400,0.0
702,2544,7667,19,1929,7608,5530,2992,760,33,760,425300.0,132600,167,1784,2544,107400,0.0
658,3979,9996,4,2345,9863,7949,4622,1069,33,1069,591300.0,149100,64,2910,3979,550000,1.0
621,7523,18264,10,5200,18086,14809,9254,1455,440,1455,783600.0,85100,182,6068,7523,96400,1.0
796,107241,266153,1945,78044,263563,213994,118806,31507,2559,31507,24887200.0,130200,2510,75734,107241,339600,1.0
971,19006,50333,140,14889,50055,38855,20566,5311,169,5311,4945300.0,188300,256,13695,19006,96900,0.0
851,40239,110801,588,29833,108546,87482,45400,12728,1297,12728,10655500.0,140100,557,27511,40239,95000,0.0
622,6620,15794,0,4582,15545,12774,7407,1494,143,1494,833300.0,105100,102,5126,6620,203600,1.0
1224,340669,931826,32561,277693,925989,741374,358421,90869,5867,90869,114797500.0,289900,5706,249800,340669,155000,0.0
779,83673,198134,1367,61838,196077,158182,91229,25621,1513,25621,19996400.0,136100,1017,58052,83673,94200,0.0
465,2432,6776,17,1363,6642,5282,3984,718,135,718,329700.0,53200,98,1714,2432,301600,1.0
702,5230,12416,4,3795,12264,9967,5709,1256,30,1256,840700.0,132500,45,3974,5230,237700,1.0
643,12060,32829,8,8435,28914,27156,13905,2934,255,2934,1748800.0,99900,472,9126,12060,88000,0.0
680,13894,34442,44,10009,32406,28483,15524,4316,309,4316,2859000.0,103400,170,9578,13894,224800,1.0
1044,1956561,5238541,463637,1500656,5192360,4195610,2183987,844178,63216,844178,945226600.0,227400,38206,1112383,1956561,263900,1.0
712,20830,51619,62,15138,51134,41177,22636,5236,380,5236,3583200.0,139900,344,15594,20830,218200,1.0
666,44310,107587,707,30938,105020,86235,50467,13312,1329,13312,8940400.0,95900,886,30998,44310,210000,1.0
634,19604,45839,94,13893,45092,37027,22004,6067,627,6067,3880100.0,97700,342,13537,19604,94400,0.0
582,7117,16569,40,4654,16528,13190,7971,1666,106,1666,876800.0,78600,136,5451,7117,190400,1.0
545,6144,14186,36,4120,13848,11379,7185,1392,189,1392,630200.0,69700,130,4752,6144,155300,1.0
759,14547,38942,63,10958,38365,30577,15478,2527,112,2527,1995000.0,160300,199,12020,14547,178000,1.0
625,16346,39302,50,9892,38825,31621,18660,4579,230,4579,2478200.0,69900,533,11767,16346,161800,1.0
584,3019,6927,12,2077,6866,5805,3861,622,16,622,312200.0,88100,92,2397,3019,221900,1.0
630,11481,31597,117,7672,31242,26929,14443,3822,1681,3822,2407000.0,94600,318,7659,11481,264800,1.0
1146,110860,308043,4100,90233,306816,242245,117813,22849,1340,22849,26606200.0,212600,1834,88011,110860,146300,0.0
811,66070,173231,1373,52528,172081,139450,71852,23209,3011,23209,20410600.0,163800,684,42861,66070,344000,1.0
617,5856,14711,0,4202,14407,11421,6405,1415,76,1415,950800.0,107500,95,4441,5856,112700,1.0
552,8223,21467,32,5513,18847,17855,9565,2086,435,2086,937500.0,80500,162,6137,8223,253000,1.0
542,6629,15930,6,4497,15409,12753,7973,1492,131,1492,685600.0,74700,201,5137,6629,369300,1.0
407,1639,4360,0,743,4178,3723,2778,240,10,240,81600.0,84100,46,1399,1639,169500,1.0
692,60064,146205,1039,43290,143569,117081,66063,18630,2256,18630,13248100.0,115600,1027,41434,60064,180100,1.0
824,103125,264433,4920,75386,258591,208680,119355,36016,3207,36016,29499000.0,122600,2374,67109,103125,110800,0.0
553,9183,21906,29,6122,21713,17799,10564,1768,80,1768,929500.0,86800,164,7415,9183,195100,1.0
586,4915,11568,7,3253,11491,9274,5564,1204,137,1204,670800.0,79000,131,3711,4915,228300,1.0
850,81418,207946,6056,63198,205992,173003,90783,37013,4808,37013,34248600.0,154800,1952,44405,81418,164000,1.0
600,1881,4897,23,1162,4818,4009,2870,335,77,335,143900.0,110900,53,1546,1881,116400,1.0
560,4287,10899,15,2990,10773,8704,4881,898,63,898,438600.0,94000,70,3389,4287,271400,1.0
629,5684,13470,9,4016,13062,10764,6336,1649,83,1649,939500.0,100600,68,4035,5684,213000,1.0
653,9795,22046,95,6720,21888,18388,13686,2118,260,2118,1278300.0,143300,202,7677,9795,207900,1.0
1080,175930,529402,6643,143418,526131,405046,185566,46956,2107,46956,51984600.0,223400,2546,128974,175930,384100,1.0
1249,39882,122933,1918,35264,122623,90686,41463,7237,196,7237,9132700.0,214700,267,32645,39882,168900,0.0
608,6271,16457,0,4342,14017,13623,7047,1812,58,1812,968700.0,72400,109,4459,6271,285300,1.0
577,2066,6791,7,1409,4809,5878,2451,438,12,438,227500.0,88600,54,1628,2066,162300,1.0
610,16001,38305,56,11100,37607,30446,18228,4108,352,4108,2260400.0,71900,206,11893,16001,238300,1.0
636,4900,11925,0,3327,11660,9824,5907,829,116,829,463100.0,103300,127,4071,4900,275800,1.0
615,6034,13904,0,4101,13698,11338,7058,1372,31,1372,764300.0,81000,90,4662,6034,116000,1.0
632,11845,28457,10,8371,28018,22940,13508,2848,248,2848,1684600.0,96800,221,8997,11845,233800,1.0
632,13892,33562,77,9369,31656,27395,15593,3443,232,3443,2039900.0,87500,366,10449,13892,197400,1.0
529,5624,13393,3,3796,13227,10778,6413,1177,21,1177,534900.0,77200,232,4447,5624,123800,1.0
411,2272,5226,4,1436,5226,4210,2748,528,44,528,179300.0,71500,64,1744,2272,130800,1.0
665,23942,59115,235,16934,58476,49469,28921,11236,2532,11236,7413100.0,108600,567,12706,23942,265600,1.0
827,13227,33739,48,10153,33471,27009,13931,2375,140,2375,2068100.0,195500,269,10852,13227,344500,1.0
756,74515,186145,2006,54805,183888,146373,83753,26093,3509,26093,19975800.0,128000,1977,48422,74515,200500,1.0
517,6686,17267,0,4493,17116,13947,7993,1321,163,1321,621900.0,98600,96,5365,6686,225200,1.0
753,114491,287512,1448,84663,284338,227253,125800,38768,2804,38768,29962200.0,115900,2044,75723,114491,85600,0.0
779,6676,16433,50,5131,16386,13214,7389,1224,98,1224,914800.0,128100,80,5452,6676,112200,0.0
525,2246,5691,7,1252,5685,4593,3170,590,66,590,277400.0,63500,54,1656,2246,171800,1.0
608,2856,7181,13,1890,7103,6024,3454,579,98,579,316100.0,83400,35,2277,2856,300100,1.0
596,2330,5551,12,1662,5451,4489,2662,458,37,458,244600.0,85600,39,1872,2330,116500,1.0
608,7669,17603,17,5204,17320,14341,8823,1991,191,1991,1071700.0,80000,119,5678,7669,109200,1.0
668,6132,17034,25,4213,15779,14191,7211,1329,365,1329,800800.0,115200,107,4803,6132,141300,1.0
852,18709,53638,67,14258,53247,41261,20054,3889,203,3889,3429700.0,145700,352,14820,18709,285900,1.0
666,13816,33619,116,9971,33253,27107,15696,3298,343,3298,2032000.0,106800,372,10518,13816,168700,1.0
616,6573,14704,44,4319,14535,12176,8458,1525,106,1525,835500.0,99400,126,5048,6573,240000,1.0
643,21006,52540,71,14853,51845,44229,23543,8010,1151,8010,5232900.0,93800,243,12996,21006,557000,1.0
605,7665,19214,11,5269,17334,15845,8693,1686,84,1686,953100.0,82900,148,5979,7665,346500,1.0
613,8831,22215,0,6263,21860,18058,10100,1652,267,1652,959700.0,135400,235,7179,8831,186400,1.0
645,2438,5771,0,1731,5763,4772,3125,493,13,493,269800.0,120800,40,1945,2438,669400,1.0
562,6704,16176,8,4864,15900,13090,7565,1484,212,1484,701500.0,98000,75,5220,6704,119700,1.0
612,7659,21980,67,5111,20167,17939,9297,1475,168,1475,824100.0,84000,272,6184,7659,70800,0.0
695,13416,34670,28,9466,31602,28594,15098,3511,381,3511,2324200.0,116500,418,9905,13416,245100,1.0
683,11011,29488,40,7892,25981,24546,12081,2995,230,2995,1996800.0,101300,165,8016,11011,334600,1.0
658,18663,45960,38,13094,45434,37300,21639,4353,393,4353,2771300.0,98400,552,14310,18663,324400,1.0
544,6460,15953,0,4322,15750,12799,7512,1864,197,1864,951300.0,83200,144,4596,6460,220700,1.0
584,9938,24430,45,6302,23957,19711,11719,2730,214,2730,1342900.0,70500,255,7208,9938,243800,1.0
640,5897,14260,38,4221,14052,11486,6635,1266,37,1266,656000.0,108100,116,4631,5897,117400,1.0
627,11234,29173,65,7484,25244,24076,13107,2467,218,2467,1313100.0,81000,377,8767,11234,91700,1.0
673,23468,56823,38,16921,55940,45519,25820,5797,511,5797,3816500.0,102200,660,17671,23468,230600,1.0
612,27461,66787,135,19715,65509,53428,30167,8088,701,8088,4964800.0,120200,610,19373,27461,204400,1.0
783,14183,37640,191,10468,35491,30582,15704,2743,130,2743,2229800.0,142900,243,11440,14183,236800,1.0
887,37420,104473,903,29895,103721,84004,41143,16281,1099,16281,15150300.0,166800,479,21139,37420,165000,0.0
487,2810,6570,3,2055,6538,5232,3183,463,15,463,225900.0,73500,62,2347,2810,170000,1.0
568,3723,9608,0,2493,9547,7658,4350,687,29,687,442700.0,99000,35,3036,3723,95100,0.0
623,15244,38358,132,10577,35819,30678,16954,4065,248,4065,2419600.0,92700,109,11179,15244,139900,1.0
657,31355,79207,233,21015,76608,62372,36121,9427,1264,9427,5876900.0,75900,3203,21928,31355,113500,1.0
1112,226668,687727,12758,185785,680356,530285,241498,42588,3587,42588,48717300.0,216400,4334,184080,226668,119400,0.0
697,26862,67477,135,18305,65458,54057,31082,7466,996,7466,4994900.0,106400,504,19396,26862,73500,0.0
669,6809,15924,0,5010,15699,12708,7787,1748,74,1748,1123200.0,87400,63,5061,6809,179800,1.0
674,7580,19830,0,5579,19665,15399,8431,2085,220,2085,1349300.0,102700,129,5495,7580,105700,0.0
610,13450,34164,61,10140,33765,26890,14816,3007,243,3007,1803100.0,137300,152,10443,13450,93000,0.0
631,14069,35733,32,9459,33129,29471,16296,3163,322,3163,1921200.0,84800,335,10906,14069,104800,1.0
588,5087,13311,11,3345,13022,10818,6404,1111,151,1111,583100.0,76900,122,3976,5087,33800,0.0
581,3413,8259,43,2174,8179,6632,4108,724,32,724,311500.0,91500,57,2689,3413,97800,1.0
352,1452,4161,7,788,4080,3528,2195,287,42,287,92100.0,63200,71,1165,1452,67200,1.0
624,19991,49649,30,13690,48907,39799,22161,4356,410,4356,2537600.0,115800,413,15635,19991,121000,1.0
620,4486,12899,3,2687,10612,10893,5626,831,72,831,416100.0,96600,90,3655,4486,92200,0.0
600,20981,51374,64,13684,48604,42434,23958,7119,297,7119,4157100.0,81700,378,13862,20981,112600,1.0
1127,244523,704476,15392,198145,689014,549765,262553,64998,4891,64998,76173500.0,251400,4266,179525,244523,67200,0.0
655,14379,36812,10,10343,34348,29742,15910,3947,382,3947,2423300.0,109500,330,10432,14379,172800,1.0
714,6084,14594,15,3631,14363,11719,7135,1613,0,1613,1090600.0,82500,126,4471,6084,90500,1.0
543,2111,5109,21,1439,5059,4105,2453,514,49,514,216700.0,87500,29,1597,2111,137300,1.0
719,54751,134695,273,40669,132156,107082,58584,13026,1223,13026,9888300.0,137300,715,41725,54751,143700,1.0
597,5160,12880,1,3789,12727,10120,5831,1374,139,1374,725400.0,76800,90,3786,5160,95400,1.0
589,6802,17429,44,4911,17230,14055,7694,1718,148,1718,984600.0,83900,64,5084,6802,92000,1.0
869,55014,144436,2417,43211,143445,124110,60757,25221,2214,25221,23661700.0,163900,679,29793,55014,116800,0.0
633,6987,16620,36,5028,16430,13292,7855,1814,165,1814,1000600.0,93500,126,5173,6987,135100,1.0
747,71733,202924,399,56801,200465,152334,78508,22493,1824,22493,16425600.0,130800,1517,49240,71733,120500,0.0
665,8792,22966,6,5985,22955,18297,11088,1742,108,1742,929200.0,101600,187,7050,8792,126400,1.0
562,4007,10598,13,2486,10532,8559,5543,673,111,673,316800.0,86700,12,3334,4007,112800,1.0
640,14840,38248,82,10709,37521,30475,16399,3884,198,3884,2359600.0,84100,386,10956,14840,75800,0.0
604,12653,32431,3,8786,32132,26096,15242,2567,362,2567,1325800.0,95900,480,10086,12653,92000,0.0
836,367215,939964,8143,282291,929787,730165,421152,168781,18527,168781,145678500.0,123500,5689,198434,367215,104800,0.0
665,26397,66972,88,18061,65748,53898,31325,8606,1878,8606,5603900.0,96500,591,17791,26397,93100,0.0
676,26122,67615,49,17894,66755,55080,30453,8264,1011,8264,5455400.0,87600,1047,17858,26122,124300,1.0
736,44448,111151,95,32332,108005,89795,50087,12142,920,12142,8775300.0,126100,800,32306,44448,97400,0.0
650,10680,26375,3,7915,25958,20903,11787,2487,71,2487,1403300.0,96000,284,8193,10680,99200,0.0
1026,57153,158170,55,46920,155413,122198,59589,12176,1096,12176,12306200.0,171600,434,44977,57153,103600,0.0
586,16524,42379,12,12761,41577,33167,17748,3805,248,3805,2254500.0,146000,264,12719,16524,86100,0.0
668,8843,22835,14,6594,22750,18007,9671,1744,94,1744,1116100.0,152200,264,7099,8843,82100,0.0
868,27576,72776,22,21831,72176,57538,29351,6218,342,6218,5437900.0,161800,630,21358,27576,91300,0.0
729,16549,43779,79,12135,43125,34244,18818,4522,288,4522,3048700.0,114600,397,12027,16549,188700,1.0
678,34538,82457,114,23742,81532,65980,39067,10958,1206,10958,7300700.0,101300,848,23580,34538,108100,1.0
716,2479,5911,6,1848,5860,4875,2820,520,43,520,333400.0,142400,10,1959,2479,101000,0.0
673,8551,20957,100,6058,20801,16971,10117,1789,119,1789,1034400.0,110200,394,6762,8551,123200,1.0
563,6112,17062,31,4188,15620,13787,8146,1391,78,1391,629600.0,86700,374,4721,6112,112400,1.0
623,10495,25203,42,7422,24840,20076,11706,2531,116,2531,1432700.0,79500,267,7964,10495,122300,1.0
645,13469,33481,28,10227,33097,26599,14596,2758,91,2758,1779400.0,131600,167,10711,13469,106800,0.0
707,3397,8685,13,2525,8599,6764,3919,888,29,888,570900.0,84900,134,2509,3397,299600,1.0
886,6011,15007,14,4214,14875,12645,8583,989,101,989,788100.0,174800,341,5022,6011,493500,1.0
704,11961,32455,10,9208,31850,24863,13301,3409,307,3409,2287400.0,103700,254,8552,11961,208400,1.0
734,13162,37543,5,9840,34443,31061,14957,3469,162,3469,2553500.0,120300,428,9693,13162,470500,1.0
741,2860,7225,3,1884,7168,5847,3248,784,79,784,573900.0,109900,33,2076,2860,208200,1.0
639,10570,27807,13,7518,27533,21964,12335,2536,126,2536,1337600.0,106200,327,8034,10570,167700,1.0
641,11482,32777,38,8425,32308,24213,12553,3004,351,3004,1899000.0,115400,138,8478,11482,197000,1.0
735,18667,49564,89,14137,49016,39452,20361,3897,439,3897,2857800.0,160800,468,14770,18667,172200,1.0
687,18096,48649,26,12051,45400,39912,21214,4869,963,4869,3168600.0,94800,620,13227,18096,191100,1.0
663,14986,37763,40,11051,36959,30803,17071,5390,620,5390,3315800.0,87200,187,9596,14986,168500,1.0
674,18432,45669,24,13146,45029,36757,21105,3909,479,3909,2320800.0,109200,724,14523,18432,337800,1.0
742,51647,129641,102,35775,124831,104437,59002,15953,1518,15953,11217300.0,91900,1460,35694,51647,207000,1.0
585,7460,19229,11,5207,17575,15562,8618,1695,119,1695,888700.0,103000,166,5765,7460,187900,1.0
634,5096,12471,6,3638,12250,10001,5786,877,35,877,464000.0,89300,100,4219,5096,171500,1.0
665,5296,12761,8,3825,12636,10235,6096,1252,109,1252,673500.0,92600,67,4044,5296,318400,1.0
698,10140,25599,0,7350,25357,20625,11437,1718,225,1718,1102400.0,138800,110,8422,10140,173500,1.0
729,13810,34459,33,10384,34207,28189,19779,3067,294,3067,1941100.0,136300,503,10743,13810,275000,1.0
763,3395,8269,9,2463,8182,6649,3722,545,71,545,338000.0,112500,40,2850,3395,216900,1.0
581,6533,15644,43,4221,15437,12659,7506,1631,56,1631,824100.0,74600,214,4902,6533,170800,1.0
662,10944,27832,9,8382,27221,21724,11805,2255,381,2255,1432600.0,121000,257,8689,10944,181800,1.0
767,29046,76481,317,22201,75442,60790,32501,8053,1160,8053,5591000.0,159700,758,20993,29046,139100,0.0
719,142696,367747,1426,110240,364079,282242,155963,45255,4558,45255,32832100.0,119400,2200,97441,142696,216000,1.0
767,10354,26480,47,7902,26154,20775,11320,3172,171,3172,2233700.0,121800,135,7182,10354,187000,1.0
708,46304,115938,938,33281,114544,96707,52668,16572,1794,16572,11785200.0,88600,860,29732,46304,209000,1.0
706,13465,36035,20,9781,33829,29201,15416,4006,286,4006,2494000.0,85500,433,9459,13465,274500,1.0
723,12677,32293,47,9461,30590,26597,14417,3584,383,3584,2559300.0,120000,512,9093,12677,139800,1.0
735,10753,27840,55,8111,27599,22156,12238,2766,128,2766,1893200.0,99900,126,7987,10753,143100,1.0
896,54867,149359,234,43152,147386,115892,59511,15893,1062,15893,14372200.0,149700,1567,38974,54867,125100,0.0
784,25805,69533,45,19561,68698,55402,28199,6042,660,6042,4552200.0,147200,314,19763,25805,166300,1.0
671,13336,33596,10,10018,33011,26659,14968,3024,237,3024,1849000.0,105700,144,10312,13336,134600,1.0
715,5530,14056,24,4059,13840,11415,6054,1381,100,1381,774200.0,112500,155,4149,5530,149400,1.0
589,7830,19623,0,5308,19371,15574,9213,1930,191,1930,992800.0,90400,230,5900,7830,197500,1.0
743,100694,268613,1783,75602,266134,211358,116078,32333,6134,32333,23209100.0,118600,2173,68361,100694,129900,1.0
733,30265,78720,48,22988,78008,61649,38037,7633,605,7633,5475500.0,142700,901,22632,30265,110100,0.0
681,17249,46752,86,12694,46257,36164,20107,4231,387,4231,2685600.0,130100,490,13018,17249,173200,1.0
763,4259,10617,0,3001,10514,8241,5217,1254,64,1254,928500.0,114300,163,3005,4259,130800,1.0
751,74923,181831,1290,55933,179469,146253,83823,26934,2176,26934,20219700.0,121200,1055,47989,74923,121300,0.0
614,5199,12214,25,3475,12054,9913,6035,1226,95,1226,673300.0,68500,231,3973,5199,184300,1.0
680,7819,19994,9,5779,19882,16008,9531,1428,108,1428,926000.0,124100,176,6391,7819,169000,1.0
769,8892,23722,0,6252,23334,18863,10564,2224,434,2224,1469700.0,98800,303,6668,8892,113100,1.0
696,14693,39450,10,10871,39182,31582,16872,2553,142,2553,1542600.0,136400,335,12140,14693,233600,1.0
690,14616,36520,49,10755,36082,29425,15993,3457,280,3457,2342500.0,102700,357,11159,14616,155300,1.0
729,42975,110839,383,31730,102536,89517,49014,12258,730,12258,8719200.0,126700,806,30717,42975,139800,1.0
663,12920,31848,90,9278,30840,26012,14175,3353,189,3353,2095100.0,96700,402,9567,12920,145600,1.0
703,9723,24279,12,7220,23989,19277,13054,2100,10,2100,1299200.0,105800,338,7623,9723,150200,1.0
764,12220,33448,73,9217,33093,26387,13461,2883,210,2883,2026800.0,153200,249,9337,12220,164700,1.0
608,8195,21107,31,5603,20901,16301,9230,2125,225,2125,1167400.0,85000,128,6070,8195,142600,1.0
506,4251,10219,10,2960,10015,8176,4811,829,29,829,357400.0,97900,78,3422,4251,150300,1.0
899,63251,167391,1089,48671,165816,134263,67777,15549,869,15549,14445400.0,173100,2167,47702,63251,117100,0.0
754,17603,44339,44,13287,43651,35210,19197,4678,586,4678,3464100.0,125300,536,12925,17603,169900,1.0
682,11150,28372,18,8288,27900,22491,12230,2601,289,2601,1773400.0,139500,235,8549,11150,149500,1.0
650,8101,20610,15,5840,20394,16538,9033,1457,126,1457,846300.0,117900,188,6644,8101,130200,1.0
668,7601,20900,14,5049,18838,17175,8931,2073,276,2073,1227500.0,80900,196,5528,7601,144000,1.0
725,6365,15290,24,4712,15107,12548,7004,1294,46,1294,730400.0,110300,253,5071,6365,110400,0.0
823,68771,186081,2440,55728,184375,151543,74721,31511,2363,31511,27621100.0,144300,750,37260,68771,153700,1.0
717,41164,107723,499,29962,103558,88039,46876,16256,1688,16256,11959700.0,90700,1003,24908,41164,113200,1.0
826,23742,61581,72,18458,60870,48258,25315,4624,315,4624,3786000.0,158100,174,19118,23742,163800,0.0
1103,114282,309687,267,97167,308195,231512,120138,25098,2438,25098,28440000.0,240000,1937,89184,114282,152300,0.0
695,16317,42524,16,12552,42171,33280,17823,3828,441,3828,2415400.0,113600,375,12489,16317,187000,1.0
717,12064,38720,39,9803,38548,27215,14554,2166,164,2166,1355700.0,172500,168,9898,12064,157700,0.0
854,31472,81024,220,23793,80159,63671,33897,9127,975,9127,7604800.0,139400,498,22345,31472,167000,1.0
650,6672,16765,35,4681,16580,13358,7496,1830,252,1830,1156700.0,100000,259,4842,6672,152000,1.0
888,24228,63013,21,20075,62385,47958,25977,5861,563,5861,5538300.0,207500,353,18367,24228,167800,0.0
639,7934,20296,9,5401,20081,16009,9713,1793,213,1793,1120500.0,93600,158,6141,7934,151400,1.0
852,185524,488694,5823,137059,485186,384877,211379,57038,5849,57038,45554000.0,140100,4703,128486,185524,152700,1.0
661,14993,38288,75,11435,37742,30401,16608,4251,390,4251,2750300.0,118400,306,10742,14993,159100,1.0
673,18205,47421,0,13785,46634,36823,20396,4662,253,4662,3019700.0,114500,415,13543,18205,196400,1.0
588,12453,35018,0,9221,34582,25140,13203,2962,316,2962,1603800.0,118900,192,9491,12453,131100,1.0
797,43657,114893,498,32735,113268,91602,49657,12500,2039,12500,9894400.0,131500,1189,31157,43657,127200,0.0
680,9410,23426,42,6267,23090,18880,10847,2937,359,2937,1905000.0,81400,377,6473,9410,174500,1.0
593,6926,17326,7,5289,17160,13683,8065,1231,109,1231,734200.0,126000,57,5695,6926,156100,1.0
661,6872,17945,1,4839,17790,14967,7605,2249,79,2249,1451000.0,114300,120,4623,6872,159000,1.0
489,2631,6405,13,1723,6303,5004,3189,509,65,509,214000.0,74700,32,2122,2631,207100,1.0
562,6037,13940,11,4346,13625,11106,7716,1420,209,1420,745600.0,122800,97,4617,6037,143700,1.0
727,89061,220008,793,70750,218065,173717,95706,22972,2818,22972,16999000.0,150600,1293,66089,89061,133200,0.0
748,67100,171493,626,50304,169756,134770,73504,20678,2613,20678,17177900.0,153200,1066,46422,67100,174500,1.0
939,31363,80864,73,26731,80343,60395,33265,7803,605,7803,7597500.0,218000,356,23560,31363,273000,1.0
617,6101,13944,150,4445,13733,11090,6661,1767,105,1767,1117500.0,108000,98,4334,6101,136800,1.0
608,10187,25646,9,7652,25398,20236,11132,1865,101,1865,1138500.0,147800,217,8322,10187,220200,1.0
614,6278,14822,16,4423,14554,11747,6758,1331,168,1331,844100.0,112100,62,4947,6278,257800,1.0
742,38076,96571,482,29972,95282,76878,40818,10600,792,10600,8438900.0,157200,297,27476,38076,202600,1.0
629,2997,6985,0,2149,6865,5627,3457,746,82,746,416400.0,100200,112,2251,2997,207900,1.0
653,6367,15201,0,4568,15004,12096,7189,1807,115,1807,1084700.0,98900,74,4560,6367,144900,1.0
553,3191,6972,1,2168,6815,5615,3758,789,135,789,387700.0,73400,68,2402,3191,827400,1.0
603,2694,6214,0,1866,6115,4922,3104,644,65,644,368800.0,76100,71,2050,2694,205800,1.0
594,5309,12497,14,3738,12359,9987,5938,1558,155,1558,1015100.0,94300,140,3751,5309,173700,1.0
502,2877,7308,11,1964,7249,5740,3648,462,71,462,215600.0,82700,187,2415,2877,254800,1.0
536,3179,7502,20,2252,7398,6092,3539,615,39,615,314600.0,98000,86,2564,3179,261500,1.0
561,2063,4986,0,1360,4785,3919,2613,518,22,518,242200.0,79600,20,1545,2063,154600,1.0
476,1654,3785,2,1141,3716,3087,2010,367,0,367,139800.0,84900,90,1287,1654,220200,1.0
549,3210,7192,7,2328,7051,5810,3690,750,132,750,375100.0,93200,88,2460,3210,226900,1.0
560,2679,5711,16,1801,5566,4710,3006,577,41,577,271400.0,68800,36,2102,2679,165700,1.0
557,5298,12140,20,3819,12004,9618,5702,1158,56,1158,753400.0,105100,39,4140,5298,168200,1.0
730,3870,9267,16,2986,9126,7273,4178,1226,63,1226,832600.0,105000,41,2644,3870,177500,1.0
658,3255,8834,2,2278,8723,6515,3605,611,77,611,330400.0,109100,51,2644,3255,162700,1.0
743,8039,17000,44,5829,16817,14192,13442,1939,173,1939,1398900.0,175900,119,6100,8039,151800,0.0
453,3043,6965,0,2210,6838,5536,3428,765,136,765,345900.0,91900,66,2278,3043,194100,1.0
929,57423,144425,4303,47667,142813,118086,60952,23391,1662,23391,23439200.0,210400,562,34032,57423,272600,1.0
650,4471,10223,12,3108,10102,8161,4892,1028,41,1028,580100.0,83700,72,3443,4471,169900,1.0
613,3347,7912,5,2357,7779,6182,3956,795,94,795,442900.0,99100,25,2552,3347,93500,0.0
672,6675,17236,6,4894,16862,13602,7771,1508,108,1508,726900.0,105300,266,5167,6675,95400,0.0
636,14531,35321,26,10310,34971,28168,16076,4118,636,4118,2425100.0,81000,287,10413,14531,100300,1.0
668,12113,34692,45,9683,34293,26174,12713,2425,187,2425,1529900.0,153800,174,9688,12113,98700,0.0
649,4232,10326,20,2951,10178,8196,4856,1158,131,1158,694400.0,87100,158,3074,4232,147300,1.0
541,4229,9814,16,2886,9051,7933,5047,970,153,970,488800.0,77800,75,3259,4229,108000,1.0
575,8675,20428,29,6232,20072,15879,9452,2158,258,2158,1144300.0,127400,128,6517,8675,96500,0.0
705,7546,18368,30,5747,18134,14655,8177,1566,105,1566,947300.0,143800,136,5980,7546,113500,0.0
673,19201,43134,141,13835,42521,35401,22325,5967,579,5967,4049900.0,121500,529,13234,19201,85700,0.0
556,6924,15904,12,4925,15687,12710,7542,1908,139,1908,1107500.0,102400,114,5016,6924,106200,0.0
605,3912,9046,10,2858,8932,7300,4544,1010,97,1010,476500.0,88900,88,2902,3912,92000,0.0
607,7183,17239,2,5077,16685,14005,8199,1700,165,1700,1013700.0,91300,261,5483,7183,177400,1.0
623,4364,11238,5,3256,11103,8940,5032,981,32,981,501500.0,104200,72,3383,4364,112400,1.0
675,3703,8600,0,2577,8464,6924,4219,851,32,851,517300.0,84900,59,2852,3703,99500,1.0
633,4489,11745,5,3462,11575,8763,4990,682,81,682,388800.0,125200,100,3807,4489,92200,0.0
549,4590,10545,13,3309,10321,8540,5188,1184,148,1184,672400.0,94400,144,3406,4590,121500,1.0
562,3823,9110,11,2787,8906,7299,4617,954,166,954,537000.0,98100,158,2869,3823,117300,1.0
612,5055,11772,25,3502,11554,9484,5571,1059,12,1059,589800.0,111700,130,3996,5055,134900,1.0
569,5407,12547,16,3458,12431,10061,6619,1296,275,1296,706300.0,78000,63,4111,5407,117400,1.0
673,7772,19865,0,5674,18717,15918,8328,2241,150,2241,1385900.0,107900,51,5531,7772,89400,0.0
524,6766,16231,14,5286,15965,12879,7293,1529,150,1529,789000.0,143900,95,5237,6766,75000,0.0
696,14533,36789,69,10718,35189,29496,16227,3817,415,3817,2695000.0,122800,274,10716,14533,97800,0.0
585,6405,15393,8,4486,14386,12746,7206,1686,119,1686,1017300.0,87600,175,4719,6405,137500,1.0
630,8123,20575,8,6125,20313,17198,8870,1778,50,1778,1232800.0,161500,111,6345,8123,104200,0.0
697,7571,18428,0,5564,18132,15214,9065,2284,111,2284,1519100.0,131100,287,5287,7571,88100,0.0
790,36926,93287,414,27893,92190,73577,39846,11725,638,11725,9071600.0,133500,521,25201,36926,131300,0.0
679,15541,40476,18,11314,39585,31422,16751,4639,120,4639,3070700.0,104600,321,10902,15541,110200,1.0
631,7625,17711,16,5314,17483,14279,9078,1857,152,1857,1118600.0,116500,136,5768,7625,88800,0.0
670,10998,26381,30,8588,25813,21294,11873,2695,194,2695,1807000.0,130500,132,8303,10998,139000,1.0
625,9445,24741,47,7072,24407,19994,10232,1755,132,1755,1115200.0,155100,183,7690,9445,101200,0.0
640,7561,20369,0,6065,20099,15679,8290,2556,193,2556,1586700.0,111100,175,5005,7561,89800,0.0
580,3883,9321,11,2833,9136,7218,4366,778,59,778,441900.0,107700,37,3105,3883,88800,0.0
662,4133,9661,6,3047,9396,7857,4798,933,38,933,674000.0,85700,121,3200,4133,92600,1.0
627,4393,10664,3,3148,10542,8539,5782,868,262,868,512400.0,112600,207,3525,4393,89700,0.0
579,4809,10971,28,3449,10814,8827,5337,1052,116,1052,570000.0,97600,173,3757,4809,105300,1.0
603,4221,9586,4,2973,9475,7573,4723,1100,94,1100,597900.0,93900,26,3121,4221,88000,0.0
831,6357,15720,14,5072,15538,12115,6811,1482,57,1482,1131700.0,160400,164,4875,6357,118500,0.0
654,13098,33127,64,9675,32880,26112,14110,3785,200,3785,2571600.0,146900,208,9313,13098,155700,1.0
749,8669,22095,32,6565,21773,17234,9629,2378,259,2378,1617200.0,140400,197,6291,8669,116000,0.0
624,5579,12864,0,3771,12684,10193,6504,1525,142,1525,914100.0,79200,132,4054,5579,90800,1.0
633,6053,13327,42,4371,13069,10678,6565,1855,96,1855,1074900.0,93600,101,4198,6053,114100,1.0
549,5227,11577,2,3744,11215,9359,5776,1246,56,1246,669400.0,89200,110,3981,5227,108500,1.0
618,6389,17131,2,4684,16939,13261,7011,1776,163,1776,888500.0,93400,122,4613,6389,96700,0.0
743,16772,39876,93,12068,39381,31760,18557,4677,471,4677,3281100.0,101400,342,12095,16772,101600,0.0
602,8315,20139,21,5830,19797,16360,9582,2015,180,2015,1150900.0,90800,243,6300,8315,85200,0.0
678,6068,14196,13,4551,13948,11370,6775,1399,82,1399,866300.0,107600,109,4669,6068,100200,0.0
636,6674,15166,54,4621,14920,12204,7508,1394,111,1394,861400.0,104300,103,5280,6674,90900,0.0
724,5601,14933,3,4171,14731,11821,6140,1194,117,1194,848700.0,157000,44,4407,5601,108400,0.0
572,4047,8865,0,2623,8635,7283,4742,1214,93,1214,657900.0,84300,120,2833,4047,91200,1.0
748,16414,42923,93,12901,42422,33275,18051,4522,665,4522,3092400.0,128100,277,11892,16414,89900,0.0
584,2617,6149,4,1897,6054,4851,2983,637,95,637,359400.0,89500,77,1980,2617,90300,0.0
858,181316,467235,3251,148291,462472,362001,193987,59660,4091,59660,53337200.0,165500,2739,121656,181316,91600,0.0
614,15067,36945,53,10496,35229,29884,17031,4872,393,4872,3023300.0,95300,420,10195,15067,97400,0.0
857,37106,95888,2519,30922,95168,81461,38783,17971,594,17971,16424600.0,172900,220,19135,37106,88900,0.0
723,38962,102397,434,30209,101406,78511,41915,13042,1022,13042,9268900.0,110700,525,25920,38962,119200,1.0
747,52811,132960,291,39290,131715,107149,57300,17954,1744,17954,14085800.0,139300,779,34857,52811,93200,0.0
634,5155,12354,6,3829,12198,9780,5564,1012,68,1012,638300.0,129900,54,4143,5155,103000,0.0
623,8395,19409,11,5823,19216,15713,9502,1893,182,1893,1114000.0,117000,211,6502,8395,107200,0.0
660,8264,20468,21,5995,19294,16520,8956,1998,69,1998,1251900.0,130700,197,6266,8264,165000,1.0
623,14204,34785,68,10060,33849,28106,16246,3549,379,3549,2217200.0,90200,220,10655,14204,97500,1.0
576,4302,10663,3,2881,10448,8402,4936,700,44,700,328200.0,112300,65,3602,4302,74600,0.0
664,4614,10239,19,3152,10042,8243,5231,1483,178,1483,922100.0,81800,144,3131,4614,75200,0.0
766,18621,48630,56,14680,48032,37784,19426,4281,104,4281,3608800.0,171400,97,14340,18621,90000,0.0
570,4372,9936,1,3131,9750,7984,5414,972,142,972,499800.0,88100,187,3400,4372,118600,1.0
613,8955,22301,39,6702,22072,17522,9839,2642,261,2642,1524600.0,110100,108,6313,8955,95500,0.0
628,10083,25027,0,7572,24731,19555,10734,2111,77,2111,1244800.0,150200,100,7972,10083,79500,0.0
668,8212,21101,24,6052,20844,16010,9074,1683,241,1683,984400.0,132500,102,6529,8212,136400,0.0
629,7264,16387,17,5283,16136,13041,8161,2237,55,2237,1391500.0,115700,152,5027,7264,66300,0.0
645,19877,47587,131,14405,47116,37974,21900,5118,543,5118,3193900.0,112400,399,14759,19877,152900,1.0
512,3172,8105,3,2201,7996,6591,3861,1066,105,1066,512200.0,76300,87,2106,3172,148200,1.0
464,1662,3693,0,1057,3631,3058,2250,373,23,373,135800.0,66200,47,1289,1662,87800,1.0
637,2628,7716,17,2124,7645,5511,2952,562,181,562,261600.0,102800,8,2066,2628,124100,1.0
657,5296,13322,10,3899,13185,10326,5835,1337,144,1337,952800.0,128100,25,3959,5296,161100,1.0
670,3148,7576,0,2225,7445,6065,3852,702,99,702,402300.0,92200,74,2446,3148,105300,1.0
777,1168,2790,0,854,2749,2226,1449,291,38,291,155600.0,83100,24,877,1168,101800,1.0
644,7980,20501,2,5310,20287,16111,9875,2005,638,2005,1103700.0,78400,228,5975,7980,85200,1.0
581,4123,10095,22,3053,9824,7788,4589,1054,127,1054,663800.0,116500,67,3069,4123,149100,1.0
779,8510,23188,1,6645,22632,17238,9297,1842,103,1842,1487800.0,169300,204,6668,8510,131000,0.0
817,59355,163227,742,45102,161957,122062,67730,25243,2270,25243,19793600.0,92800,984,34112,59355,102200,1.0
742,24358,66260,45,18823,63864,51212,26657,6452,625,6452,5350000.0,142400,487,17906,24358,113500,0.0
619,3406,8203,3,2557,7944,6514,4069,699,136,699,468800.0,100200,385,2707,3406,110100,1.0
524,1275,3121,11,932,3055,2506,1853,244,20,244,110100.0,68900,28,1031,1275,109900,1.0
739,22294,55334,170,16813,54446,43550,24350,7449,519,7449,5610400.0,125400,509,14845,22294,102700,0.0
672,9188,23336,24,6394,22853,18196,10930,2398,309,2398,1487500.0,86800,209,6790,9188,77200,0.0
587,1389,2899,0,1108,2819,2435,1694,294,22,294,141500.0,84400,46,1095,1389,88700,1.0
649,2732,6918,12,2009,6820,5424,3276,424,41,424,264200.0,111900,67,2308,2732,126600,1.0
626,3873,8858,10,2699,8727,7026,4657,1007,92,1007,603400.0,66700,47,2866,3873,93100,1.0
563,1523,3178,2,994,3169,2582,2020,281,75,281,113400.0,53200,45,1242,1523,112000,1.0
561,2725,6230,6,1923,6079,5049,3299,754,101,754,392500.0,85700,61,1971,2725,66400,0.0
610,1327,3001,3,877,2950,2419,1706,236,78,236,114000.0,70500,64,1091,1327,92900,1.0
497,1713,3684,1,1107,3583,2972,2185,482,35,482,207900.0,61300,40,1231,1713,77500,1.0
626,5967,16466,1,4251,16289,12925,6960,1784,90,1784,939000.0,92900,178,4183,5967,113800,1.0
594,5622,14757,9,3874,14482,11386,7149,1659,273,1659,942300.0,82600,91,3963,5622,100800,1.0
735,12648,37097,110,10713,36868,26762,13464,4793,255,4793,3351000.0,126200,123,7855,12648,127500,0.0
593,864,2621,0,666,2621,1921,1142,271,36,271,90300.0,86800,26,593,864,122500,1.0
594,1004,2524,0,713,2454,2036,1239,322,49,322,173000.0,133800,22,682,1004,115100,0.0
950,27233,79359,117,21398,72021,62465,29368,8701,600,8701,8894100.0,171000,472,18532,27233,180600,1.0
762,71601,178392,697,52058,175061,140187,79858,25190,4002,25190,20127200.0,127600,1127,46411,71601,107800,0.0
708,2729,5999,0,2050,5902,4688,3129,947,117,947,567600.0,86300,12,1782,2729,247900,1.0
554,798,2107,10,519,2079,1537,1078,175,47,175,52000.0,71900,26,623,798,82200,1.0
495,3259,7847,0,2584,7734,6273,3565,834,117,834,372000.0,114000,27,2425,3259,203500,1.0
620,1674,4295,0,1217,4171,3284,1983,471,50,471,204400.0,88700,39,1203,1674,239800,1.0
633,13619,33463,5,9272,32940,26280,16504,4060,309,4060,2344400.0,74000,534,9559,13619,179500,1.0
619,2325,5605,0,1648,5525,4553,3206,516,46,516,279900.0,95100,154,1809,2325,275000,1.0
709,3742,9670,1,2728,9440,7517,4490,1078,157,1078,730500.0,87600,53,2664,3742,131400,1.0
611,1170,2520,4,842,2481,2085,1446,301,10,301,111400.0,81700,20,869,1170,110200,1.0
526,2144,5148,0,1483,4949,4121,2768,430,22,430,211500.0,75400,77,1714,2144,143000,1.0
652,3206,7840,0,2116,7734,6063,3743,922,18,922,557300.0,88200,38,2284,3206,349300,1.0
655,912,2089,0,646,2031,1631,1154,280,51,280,126900.0,76400,58,632,912,236800,1.0
605,2500,6331,10,1754,5440,5335,3231,579,48,579,306300.0,88500,125,1921,2500,272300,1.0
1052,12923,35796,24,10980,29856,25523,15301,7879,1175,7879,8114300.0,141900,295,5044,12923,243000,1.0
664,2357,5746,4,1707,5595,4512,3182,634,290,634,371900.0,66700,32,1723,2357,149600,1.0
709,11339,34658,28,9265,34157,25123,12220,4246,306,4246,2981800.0,108400,94,7093,11339,183200,1.0
560,3161,6987,3,2180,6867,5707,3884,747,55,747,402500.0,90100,82,2414,3161,258100,1.0
643,13552,33302,97,10674,32903,26612,15267,5757,516,5757,3744000.0,98500,198,7795,13552,169300,1.0
537,4209,9859,36,2972,9699,7777,4890,1032,262,1032,529700.0,93400,56,3177,4209,344000,1.0
549,2590,6776,0,1849,5699,5697,3167,765,37,765,337500.0,75600,39,1825,2590,120200,1.0
573,5325,12752,54,3695,12546,10139,6309,1491,211,1491,767500.0,78600,183,3834,5325,184000,1.0
568,1248,2677,0,786,2642,2169,1510,251,22,251,98400.0,86600,26,997,1248,77700,0.0
517,726,1741,0,530,1663,1425,987,133,1,133,46900.0,73200,22,593,726,308000,1.0
677,13688,35732,0,9579,34525,28133,16115,4668,451,4668,3107500.0,85700,451,9020,13688,123000,1.0
491,1158,2581,0,675,2541,2114,1752,214,15,214,93200.0,48300,65,944,1158,314500,1.0
593,1193,2632,0,816,2584,2109,1373,271,27,271,115900.0,78900,30,922,1193,172700,1.0
754,9897,25599,66,7529,25420,20053,11213,2760,331,2760,2083800.0,121700,241,7137,9897,213100,1.0
689,13355,34683,0,9943,34049,27022,14695,3910,288,3910,2736500.0,120200,703,9445,13355,76000,0.0
610,786,1875,0,570,1840,1534,1008,218,74,218,82500.0,86700,20,568,786,242700,1.0
490,1388,2963,0,769,2932,2460,2033,275,24,275,103000.0,53700,20,1113,1388,127000,1.0
662,1242,3931,0,917,3868,2898,1563,272,108,272,139400.0,98200,63,970,1242,148500,1.0
548,3932,9868,4,2921,9661,7842,4582,1076,103,1076,549100.0,74800,132,2856,3932,77600,0.0
659,1804,4251,0,1293,4131,3319,2338,293,53,293,159900.0,61800,59,1511,1804,151100,1.0
706,12077,28792,10,9310,28121,22978,13049,3415,180,3415,2338000.0,140300,296,8662,12077,261300,1.0
633,6604,15894,3,4674,15683,12576,7553,1666,102,1666,1071700.0,107200,166,4938,6604,122000,1.0
692,494,1210,0,358,1180,959,625,174,10,174,92100.0,86100,8,320,494,82400,0.0
620,3592,8328,13,2704,8224,6765,4056,858,117,858,461800.0,111000,67,2734,3592,169800,1.0
702,14974,39099,26,10952,38465,31494,18055,6071,1262,6071,4073500.0,87300,244,8903,14974,63300,0.0
677,11647,28877,34,8908,28655,23265,13151,4433,381,4433,2967800.0,159400,289,7214,11647,121300,0.0
563,2772,6227,5,1796,6128,5097,4041,726,61,726,314700.0,61100,182,2046,2772,64500,1.0
612,8098,20553,24,5793,20228,16160,10082,2371,415,2371,1353400.0,74900,298,5727,8098,83600,1.0
653,4433,9602,12,2916,9541,7738,5558,1048,69,1048,656400.0,89400,100,3385,4433,97600,1.0
780,195072,510484,1231,149682,504644,390829,216296,70464,6289,70464,56607400.0,130900,3506,124608,195072,82800,0.0
722,7573,22948,55,6302,22750,16541,8203,2587,239,2587,1842300.0,98500,5,4986,7573,151700,1.0
543,2307,4705,0,1541,4610,3904,2888,560,34,560,282400.0,60500,281,1747,2307,101600,1.0
446,1239,2561,0,793,2532,2116,1486,238,19,238,101400.0,69600,33,1001,1239,81500,1.0
1020,224248,578797,976,184692,574871,449145,235821,69673,4238,69673,74752300.0,232500,1921,154575,224248,74400,0.0
869,44945,117806,1263,36833,117121,98041,49106,21744,1996,21744,20009800.0,188100,544,23201,44945,90200,0.0
545,1144,2497,0,784,2471,1944,1256,255,8,255,108400.0,101000,13,889,1144,110500,1.0
797,12771,32976,26,9590,32390,25732,13473,2809,97,2809,2287400.0,181100,218,9962,12771,94200,0.0
638,2141,6004,0,1682,5919,4442,2415,515,65,515,295100.0,117900,25,1626,2141,82300,0.0
478,594,1591,0,386,1571,1210,786,130,32,130,65900.0,88300,34,464,594,83800,0.0
600,1095,2665,12,723,2569,2137,1501,236,45,236,97600.0,85200,24,859,1095,106700,1.0
636,1958,5741,0,1495,5630,4157,2308,537,110,537,279200.0,110000,6,1421,1958,72800,0.0
448,2339,5572,4,1726,5435,4459,2943,460,65,460,185000.0,75300,240,1879,2339,119900,1.0
683,890,2157,0,681,2130,1654,1024,263,7,263,122000.0,84000,19,627,890,172000,1.0
575,1432,3425,0,877,3368,2793,2142,318,47,318,132700.0,63300,64,1114,1432,63000,0.0
585,1115,2931,0,805,2847,2304,1467,350,81,350,153200.0,97700,64,765,1115,98900,0.0
719,1906,5527,0,1383,4720,4557,2546,438,153,438,311100.0,73700,2,1468,1906,72700,0.0
698,25015,63360,88,18437,60842,50599,28441,7829,933,7829,5471300.0,96600,313,17186,25015,125000,1.0
626,11288,27067,97,8233,26652,21261,12698,3536,261,3536,2100100.0,87600,271,7752,11288,62800,0.0
616,3896,9191,15,2875,8951,7380,4637,1038,248,1038,569900.0,73200,371,2858,3896,93500,1.0
614,3065,7790,12,2195,7666,6410,3588,859,93,859,500600.0,95300,61,2206,3065,138400,1.0
501,1273,2946,0,974,2849,2349,1623,277,30,277,111200.0,61200,36,996,1273,68000,1.0
700,1330,4081,0,1012,4024,3028,1679,321,91,321,119200.0,102600,56,1009,1330,102400,0.0
551,828,1702,0,534,1694,1379,991,179,28,179,71800.0,76400,3,649,828,125600,1.0
574,1432,3119,0,942,3051,2545,1823,318,41,318,144100.0,69900,78,1114,1432,98300,1.0
830,2105,4981,0,1604,4884,3895,2239,537,0,537,378800.0,135900,0,1568,2105,143800,1.0
574,4857,12087,0,3358,11720,9809,5984,968,55,968,528600.0,81300,183,3889,4857,106700,1.0
601,6521,16209,10,4658,16001,12592,7748,1967,188,1967,1153200.0,77300,238,4554,6521,114900,1.0
580,3993,9736,3,2885,9664,7472,4742,1164,71,1164,608300.0,83900,75,2829,3993,148400,1.0
666,2437,5957,10,1749,5869,4776,2789,414,9,414,230900.0,98600,162,2023,2437,137000,1.0
545,2326,5446,0,1657,5345,4337,3072,507,100,507,256500.0,76900,12,1819,2326,98400,1.0
937,26686,75696,109,22393,68618,64005,30298,15402,2201,15402,14600700.0,189200,180,11284,26686,94600,0.0
562,1967,4905,0,1368,4864,3817,2792,601,148,601,267400.0,75600,35,1366,1967,113100,1.0
596,1439,2891,0,949,2808,2395,1800,407,35,407,209400.0,63400,73,1032,1439,144900,1.0
659,7781,19162,17,5583,18773,15063,9173,2109,283,2109,1324500.0,110700,428,5672,7781,98400,0.0
740,7681,18856,33,5787,18597,15037,8308,1396,54,1396,962800.0,135800,69,6285,7681,119300,0.0
622,7107,18630,0,4701,18424,14806,8246,2163,230,2163,1193400.0,132900,264,4944,7107,101800,0.0
616,5060,12735,13,3280,12521,10207,5920,1375,73,1375,706900.0,90400,45,3685,5060,130700,1.0
750,3603,8697,0,2425,8674,7023,3970,837,51,837,517000.0,110500,51,2766,3603,113500,0.0
643,4880,12063,0,3133,11969,10046,6546,951,78,951,568000.0,87100,71,3929,4880,100000,1.0
496,1877,4625,0,1100,4463,3803,2358,347,42,347,157800.0,70200,146,1530,1877,87200,1.0
616,3427,8330,5,2339,8296,6505,3858,945,98,945,466900.0,102300,104,2482,3427,293900,1.0
481,3376,8268,3,2081,6895,7239,4869,592,31,592,286100.0,122900,107,2784,3376,106600,0.0
693,17324,45131,0,13259,44838,35212,18735,3745,281,3745,2440700.0,144800,184,13579,17324,126700,0.0
519,8011,20692,53,4545,20408,16616,10915,2178,369,2178,935000.0,81400,120,5833,8011,144100,1.0
445,5496,13565,8,3098,13421,10968,6531,1383,53,1383,393300.0,68300,291,4113,5496,120900,1.0
613,7365,19335,28,4977,18573,15112,8260,1925,136,1925,1124600.0,100400,162,5440,7365,128000,1.0
598,5982,14286,0,3942,14215,11552,7900,1040,89,1040,541900.0,119500,205,4942,5982,145100,1.0
755,10063,25817,13,7543,25675,20637,10996,2969,118,2969,1904100.0,188200,354,7094,10063,145800,0.0
940,46095,127682,529,37726,126397,97459,48499,12210,667,12210,12092400.0,183700,333,33885,46095,115400,0.0
458,4292,10648,47,2076,10376,8585,5349,950,24,950,254400.0,48900,118,3342,4292,102500,1.0
808,18537,51667,59,14367,51100,40409,20140,7025,317,7025,5182200.0,164300,245,11512,18537,157900,0.0
530,12264,31424,74,6171,31073,24772,14643,4496,594,4496,1905700.0,76900,172,7768,12264,108300,1.0
571,6254,15844,14,3367,15735,12560,7369,1472,62,1472,720700.0,80400,48,4782,6254,83500,0.0
568,10065,23011,51,5290,22833,18705,11716,2600,174,2600,1047300.0,58500,546,7465,10065,105500,1.0
633,4016,9288,15,2646,9229,7581,4869,1034,93,1034,342400.0,90800,58,2982,4016,55800,0.0
640,27557,65285,107,17648,64106,52573,31737,9100,1265,9100,5709700.0,134100,1485,18457,27557,112400,0.0
651,25853,61586,136,14390,60871,50091,30769,7000,572,7000,3444700.0,75400,441,18853,25853,78500,0.0
824,16369,45831,56,12522,44672,36100,17249,5021,267,5021,3849700.0,184900,125,11348,16369,71700,0.0
612,12583,36027,76,7608,35396,28283,15355,3722,666,3722,1929100.0,83800,420,8861,12583,171700,1.0
710,8613,22017,0,6256,21912,17314,9317,2033,43,2033,1295400.0,138600,152,6580,8613,96000,0.0
550,7467,19991,83,4740,19719,15931,10731,1636,94,1636,747900.0,95200,233,5831,7467,120000,1.0
579,15108,37447,20,7842,36943,30323,18360,4477,256,4477,1926000.0,72900,172,10631,15108,95800,1.0
727,20786,49969,66,15119,49196,40677,23222,7655,523,7655,5465800.0,139300,481,13131,20786,85100,0.0
763,62929,163987,1942,49212,162466,128542,69484,21600,2000,21600,16639800.0,149700,1139,41329,62929,94600,0.0
574,6332,17748,4,3165,16203,14290,7505,1849,113,1849,834600.0,61300,137,4483,6332,154400,1.0
679,33036,88376,84,24920,87531,71657,36223,13550,848,13550,9441800.0,151000,786,19486,33036,98400,0.0
556,5057,12783,15,2686,12658,10172,6043,1582,111,1582,498500.0,63300,28,3475,5057,82500,1.0
534,3940,9990,0,2385,9891,7921,4719,935,49,935,369300.0,75200,40,3005,3940,101900,1.0
349,1696,4497,0,757,4422,3696,2222,444,15,444,146600.0,70000,15,1252,1696,75900,1.0
625,8774,24392,99,5863,24171,20212,10254,3551,520,3551,1994300.0,121100,300,5223,8774,107700,0.0
735,6895,17881,15,4753,17536,13979,7632,2553,201,2553,1734100.0,130500,175,4342,6895,79500,0.0
596,9669,25406,8,6488,25008,20409,11000,3562,175,3562,2005900.0,106700,44,6107,9669,88800,0.0
699,14216,35757,19,10122,35343,28605,15786,4881,282,4881,3257500.0,139200,369,9335,14216,104700,0.0
612,4610,12377,0,3031,12137,9411,5340,1326,213,1326,683400.0,94800,39,3284,4610,150500,1.0
628,1988,4890,0,1221,4821,3915,2454,419,25,419,227900.0,89200,182,1569,1988,160200,1.0
625,3962,10695,1,2872,10411,8229,4711,1337,36,1337,811200.0,103800,154,2625,3962,62600,0.0
536,4025,10208,17,2273,10055,8251,5310,1210,83,1210,477500.0,66100,69,2815,4025,78500,1.0
578,5638,14382,0,3217,14260,11714,6913,1663,222,1663,750000.0,71000,70,3975,5638,86200,1.0
678,3007,8652,8,2244,8542,6743,3892,862,94,862,498800.0,109900,169,2145,3007,113400,0.0
680,6925,17226,10,4781,17123,13797,7497,1512,84,1512,919500.0,131000,53,5413,6925,105900,0.0
681,14089,36012,43,8928,35605,29076,16347,3349,264,3349,1940500.0,103300,408,10740,14089,106800,0.0
533,5849,14515,19,3892,14515,11277,6662,1683,73,1683,815500.0,89900,130,4166,5849,79100,0.0
799,35870,91804,919,27412,90204,74589,39929,11195,1615,11195,8737400.0,160700,885,24675,35870,102200,0.0
567,10460,27385,17,6142,27077,22104,12439,2338,156,2338,1009500.0,83300,72,8122,10460,113400,1.0
532,2635,7533,7,1426,6294,6337,3418,609,73,609,210300.0,72700,373,2026,2635,119500,1.0
720,8637,24800,13,6242,24372,18757,10109,2836,182,2836,1957100.0,119700,256,5801,8637,115900,0.0
800,309888,764378,10027,232484,756073,610647,341885,119304,10318,119304,96051100.0,159000,4398,190584,309888,114900,0.0
693,5470,14102,0,3774,13821,11335,6329,1519,193,1519,977700.0,107300,98,3951,5470,84700,0.0
603,10780,26847,7,7034,26559,21216,12396,3515,205,3515,1917700.0,105400,153,7265,10780,125800,1.0
591,6737,17167,22,4452,16858,13609,8155,2166,318,2166,1082900.0,111200,625,4571,6737,154000,1.0
619,8645,21378,17,5994,21209,17196,10117,2439,141,2439,1338700.0,139900,184,6206,8645,115900,0.0
698,5236,14530,23,3768,14433,11624,6379,1271,265,1271,742700.0,106400,143,3965,5236,116200,1.0
469,938,2161,0,593,2099,1791,1151,221,29,221,102100.0,94500,23,717,938,53100,0.0
541,7204,17731,24,4094,17563,14160,10025,1866,201,1866,891200.0,87300,122,5338,7204,82600,0.0
630,6678,18012,24,5269,17887,14455,7049,1131,49,1131,705600.0,190900,94,5547,6678,75400,0.0
581,4507,11999,56,3045,11873,9482,5138,1056,90,1056,603000.0,105600,101,3451,4507,62100,0.0
616,4509,12189,8,2832,12099,9424,5456,1211,79,1211,637700.0,77900,158,3298,4509,88400,1.0
611,3225,8152,72,2098,8034,6520,3907,693,90,693,338600.0,102600,324,2532,3225,81600,0.0
658,16927,43418,38,11502,42693,34416,19565,5720,470,5720,3598900.0,110400,262,11207,16927,94700,0.0
671,10875,29773,8,7330,28415,24427,12433,3641,239,3641,2316200.0,141100,239,7234,10875,109900,0.0
542,4467,11044,10,2737,10924,9027,5305,1038,133,1038,458100.0,75800,19,3429,4467,148000,1.0
593,3375,8700,0,2330,8653,6728,3744,815,41,815,362000.0,109100,27,2560,3375,135500,1.0
481,11249,27548,28,5446,27072,21916,13573,3555,386,3555,1368900.0,53500,1027,7694,11249,101800,1.0
483,4316,12175,0,2068,10748,9909,5240,1202,63,1202,460300.0,65500,110,3114,4316,106400,1.0
783,41051,107699,132,31250,102841,84017,46112,15754,1538,15754,12580300.0,148000,470,25297,41051,120100,0.0
620,9786,24413,19,6485,24178,19462,10964,2594,89,2594,1414400.0,96100,119,7192,9786,95500,0.0
567,3826,9361,0,2505,9265,7335,4298,762,35,762,377500.0,96800,89,3064,3826,99000,0.0
508,4376,10645,30,2675,10510,8452,5242,1200,111,1200,486400.0,74500,21,3176,4376,107700,1.0
536,9055,24062,29,6074,23720,18989,10347,2116,165,2116,1004700.0,88300,228,6939,9055,225800,1.0
640,4878,12349,0,3018,12096,9687,5678,1530,92,1530,757600.0,79800,150,3348,4878,261700,1.0
585,5527,14915,0,3732,14748,12226,6236,1772,89,1772,940700.0,83100,106,3755,5527,143100,1.0
545,5095,13180,2,3294,12851,10494,5950,1387,171,1387,628600.0,80800,218,3708,5095,204100,1.0
548,5309,12747,16,3263,12629,10246,6273,1439,143,1439,593600.0,95300,125,3870,5309,369100,1.0
651,14757,38616,39,9801,38206,32404,18585,5374,1184,5374,3452100.0,130100,757,9383,14757,200900,1.0
480,6398,15805,11,3937,15462,12682,7484,1278,109,1278,429300.0,77600,88,5120,6398,240400,1.0
771,25275,72438,162,18569,63103,54136,29852,13251,1496,13251,10214500.0,112200,334,12024,25275,160900,1.0
698,39531,99258,220,28541,97254,77513,42714,12831,1084,12831,8891000.0,123200,629,26700,39531,251000,1.0
556,9594,26129,12,6348,25803,20563,13616,2692,112,2692,1335800.0,102200,174,6902,9594,158200,1.0
643,18719,46252,87,13017,45303,36721,20542,7139,480,7139,4335600.0,118000,207,11580,18719,233400,1.0
745,6104,15677,23,4382,15598,12430,6732,1964,70,1964,1340800.0,126100,59,4140,6104,240500,1.0
657,18546,45985,36,12281,44962,36609,21356,5468,513,5468,3228100.0,96600,479,13078,18546,148300,1.0
527,5435,13369,103,2900,13261,10718,6587,1370,122,1370,545800.0,69900,36,4065,5435,199700,1.0
615,22976,59901,10,14697,59108,47527,25762,7100,435,7100,3928600.0,102000,415,15876,22976,246500,1.0
643,13117,31177,54,8340,30628,25634,16060,2773,149,2773,1568500.0,118100,418,10344,13117,135500,1.0
818,10785,28452,39,8122,27457,22396,12336,3063,313,3063,2423000.0,140800,291,7722,10785,360400,1.0
665,10404,27550,0,7150,27222,21794,11846,3440,358,3440,2102600.0,118200,405,6964,10404,133900,1.0
578,2760,7061,34,1864,6964,5588,3261,839,93,839,391700.0,82100,64,1921,2760,268100,1.0
875,20465,64633,146,16983,60638,49999,21512,3034,89,3034,2660100.0,259700,387,17431,20465,251500,0.0
622,3944,10686,15,2530,10628,8459,5698,1048,24,1048,555300.0,99100,228,2896,3944,112900,1.0
548,6552,16815,25,4138,16524,13557,7802,1577,81,1577,710800.0,80800,99,4975,6552,125300,1.0
813,19706,52322,162,16021,52042,40312,21044,6012,327,6012,4551000.0,170800,169,13694,19706,181800,1.0
735,46443,123824,132,36011,122496,98769,50807,19160,1324,19160,14205700.0,152300,614,27283,46443,239600,1.0
650,7705,20628,11,5110,20433,16311,9422,2163,125,2163,1200000.0,102500,289,5542,7705,180200,1.0
718,8116,20017,43,5842,19795,16047,9024,3057,83,3057,1851800.0,144900,161,5059,8116,181000,1.0
645,19119,48486,46,12260,46524,39263,21674,5759,577,5759,3112100.0,103900,523,13360,19119,165200,1.0
808,29014,78622,56,21931,78282,62905,30872,5333,248,5333,3911300.0,153100,398,23681,29014,148900,0.0
502,3711,9154,29,2415,8952,7300,4592,696,45,696,281500.0,84600,68,3015,3711,89500,1.0
828,127336,315109,3214,101782,309986,255104,139679,58517,4065,58517,49807700.0,175000,1756,68819,127336,167000,0.0
501,2463,6259,19,1409,5841,5142,3360,957,170,957,426800.0,63600,471,1506,2463,156800,1.0
609,8771,23064,18,4383,22595,18356,10641,2429,128,2429,1190900.0,90300,503,6342,8771,120300,1.0
470,6158,15690,4,3234,15525,12775,7558,1431,85,1431,465800.0,52000,93,4727,6158,90900,1.0
573,2537,6381,40,1526,6306,5256,3863,452,85,452,165000.0,77800,193,2085,2537,174200,1.0
561,4937,13281,0,2863,11636,11119,5964,1255,72,1255,480500.0,77500,329,3682,4937,126800,1.0
540,11416,31153,6,7313,30321,25444,13748,2531,493,2531,1300600.0,82000,154,8885,11416,106500,1.0
569,11037,27329,27,6180,26713,21991,12915,2920,180,2920,1314900.0,73300,277,8117,11037,109900,1.0
627,25810,63974,35,15619,63214,51337,31446,7958,818,7958,4417600.0,109100,682,17852,25810,197900,1.0
496,2853,7251,0,1366,7119,5737,3712,1002,25,1002,392400.0,65700,22,1851,2853,147700,1.0
510,7719,20866,0,3988,19352,16849,8958,2214,135,2214,796800.0,55600,66,5505,7719,161400,1.0
503,7101,19304,0,4385,19031,15925,8577,1701,128,1701,683600.0,85900,58,5400,7101,162500,1.0
496,11063,27469,9,5424,26625,22316,13194,3876,336,3876,1633100.0,59400,835,7187,11063,110900,1.0
478,5342,13276,6,2699,13134,10892,6301,1438,81,1438,461100.0,50000,58,3904,5342,130000,1.0
437,2709,6744,0,1471,6656,5501,3675,807,60,807,269900.0,90300,16,1902,2709,156800,1.0
634,14299,37259,49,9349,36866,29155,16805,3741,368,3741,2053400.0,95600,1259,10558,14299,145300,1.0
508,7346,18531,0,4618,18265,14447,8886,1890,92,1890,788500.0,90200,23,5456,7346,97400,1.0
550,2843,6717,0,1327,6087,5521,3475,754,9,754,332900.0,64200,41,2089,2843,164000,1.0
812,23674,54468,187,15750,54028,46148,40916,6219,617,6219,4466700.0,207300,658,17455,23674,201900,0.0
683,20756,57230,61,13631,56902,47440,36684,4163,1573,4163,2584900.0,137200,739,16593,20756,103600,0.0
761,15241,34021,94,9895,33533,28970,23833,3300,410,3300,2301100.0,211900,424,11941,15241,130900,0.0
791,16954,39280,75,11524,39073,32620,22167,3527,211,3527,2403000.0,159800,409,13427,16954,141600,0.0
777,61848,152284,371,43627,150671,127559,75217,18716,1782,18716,14034300.0,137900,913,43132,61848,220500,1.0
621,7477,16960,11,4359,16824,14456,15414,1778,54,1778,914400.0,116100,384,5699,7477,115200,0.0
724,45263,107317,105,32940,106275,86257,49616,16310,820,16310,11891100.0,152000,445,28953,45263,214200,1.0
565,29844,68840,26,18959,67685,57675,39810,8450,1065,8450,4456500.0,97000,945,21394,29844,75800,0.0
619,14017,31822,37,8406,31231,26569,23247,3413,339,3413,1750700.0,110000,408,10604,14017,85700,0.0
1029,118807,289173,2138,89261,285941,239833,142251,37281,2322,37281,37518500.0,259400,1660,81526,118807,133600,0.0
790,17022,39700,49,11763,38577,33289,24215,4039,429,4039,3248700.0,199600,257,12983,17022,323300,1.0
843,15810,35149,20,11373,35015,29109,18638,3830,402,3830,2962600.0,199400,136,11980,15810,149700,0.0
926,83324,201454,687,62380,199598,167015,108609,21221,1937,21221,19227900.0,233000,1236,62103,83324,79800,0.0
727,51055,121289,111,36252,119783,100138,62225,15228,1200,15228,10504400.0,154500,834,35827,51055,97200,0.0
596,11577,30177,54,7898,30019,25265,22068,2340,487,2340,1289400.0,136300,304,9237,11577,305800,1.0
714,21392,50994,12,13869,50499,42185,30801,5104,425,5104,3328600.0,108000,380,16288,21392,114400,1.0
669,21721,59841,28,15620,59402,46071,26208,5098,546,5098,2689000.0,105700,419,16623,21721,169200,1.0
893,18925,52728,0,14559,52057,41078,20456,3719,362,3719,3086900.0,185800,183,15206,18925,125400,0.0
764,36153,98112,207,26895,97260,77159,40297,8990,333,8990,5903700.0,144300,297,27163,36153,181500,1.0
528,7440,20211,17,4961,18164,15919,9525,2718,263,2718,1122700.0,78500,248,4722,7440,149100,1.0
441,1930,4771,8,1060,4753,3755,3396,733,56,733,166100.0,62200,105,1197,1930,197600,1.0
853,3947,15376,4,2849,12074,13122,5363,1044,140,1044,739700.0,209600,61,2903,3947,99800,0.0
600,11435,31405,0,8020,30901,24243,13713,3265,308,3265,1693300.0,101800,201,8170,11435,200400,1.0
725,7887,21485,51,5651,21275,17001,8817,1779,130,1779,908800.0,136400,108,6108,7887,166200,1.0
721,7271,22305,42,4649,18907,17997,9201,2418,121,2418,1354300.0,93600,565,4853,7271,105500,1.0
936,168786,437038,2326,126746,433725,351706,188528,64379,6669,64379,60263200.0,176000,2209,104407,168786,138700,0.0
699,13327,36598,48,9458,35941,28596,15438,3138,197,3138,1894400.0,115200,201,10189,13327,223600,1.0
490,5840,13806,8,3563,13478,11058,7800,1633,108,1633,547100.0,76000,80,4207,5840,345200,1.0
952,48142,125698,169,36620,119547,97571,55257,17839,2158,17839,16099000.0,164600,653,30303,48142,375000,1.0
803,2686,6806,5,2049,6779,5521,3809,272,46,272,128400.0,110900,27,2414,2686,142200,1.0
732,6817,19553,9,4861,16358,16240,8324,1315,52,1315,704100.0,124100,114,5502,6817,100000,0.0
914,15421,43565,57,11950,42910,33986,17702,3693,259,3693,3123300.0,152800,256,11728,15421,126500,0.0
1118,8759,23394,20,6537,22467,17879,10094,2713,198,2713,2711800.0,165900,136,6046,8759,93800,0.0
730,56799,156433,695,40671,150783,121237,67092,23089,3159,23089,15583200.0,133400,1230,33710,56799,85100,0.0
780,48032,132080,860,33894,129374,102889,57515,18594,1891,18594,13425000.0,133800,3552,29438,48032,113900,0.0
582,17542,46449,19,11036,44595,36693,21468,4997,678,4997,2211500.0,84600,355,12545,17542,151900,1.0
616,30467,83580,45,19595,82485,63269,36458,9213,1225,9213,4668300.0,99200,501,21254,30467,79900,0.0
783,47598,128850,206,34876,128049,100282,53709,15146,1271,15146,10636200.0,149300,691,32452,47598,186000,1.0
593,22675,62607,25,15540,61694,47774,26103,6498,839,6498,3511500.0,97500,489,16177,22675,174000,1.0
752,20032,52578,59,13700,51764,41257,23413,7517,888,7517,3844200.0,97000,228,12515,20032,87800,0.0
523,4182,11274,0,2778,10683,8932,5141,1077,43,1077,329200.0,79400,147,3105,4182,187200,1.0
1012,91353,249201,201,68923,246763,194907,100551,19944,2404,19944,19302200.0,206600,1205,71409,91353,137200,0.0
466,7971,22537,58,4980,22046,18119,11596,1465,238,1465,537600.0,88700,551,6506,7971,82400,0.0
577,3680,10000,0,2167,9443,7922,5095,968,62,968,394400.0,67800,156,2712,3680,117300,1.0
764,97283,251069,1821,68768,246699,196924,112901,38870,4825,38870,28279400.0,138200,1916,58413,97283,172500,1.0
474,2417,7318,0,1407,4991,6084,3020,1326,77,1326,523500.0,68200,67,1091,2417,124700,1.0
972,41884,119129,44,33357,118306,90395,45498,8302,596,8302,7744200.0,179800,370,33582,41884,93200,0.0
834,89677,238230,798,69589,236010,187609,99562,30897,4037,30897,25450900.0,172500,1345,58780,89677,89000,0.0
533,11928,33750,4,7561,32192,26075,14918,3999,500,3999,1968700.0,90000,287,7929,11928,71400,0.0
723,26420,73346,109,18923,72549,56226,30392,8684,1100,8684,5048800.0,106700,237,17736,26420,104000,0.0
679,17370,47536,0,12988,46893,39082,19931,7905,976,7905,5180600.0,145900,136,9465,17370,72800,0.0
875,14791,45067,199,10797,44760,33960,16925,4785,506,4785,3937500.0,139200,385,10006,14791,158200,1.0
608,3990,10509,18,2539,10367,8375,5244,687,64,687,228900.0,77400,42,3303,3990,102700,1.0
633,15854,40043,56,10029,39092,31988,19584,4752,405,4752,2469400.0,81600,635,11102,15854,73000,0.0
815,9436,25518,44,7541,24763,19851,10398,2508,237,2508,1687700.0,177000,16,6928,9436,172100,0.0
608,10331,27164,74,6869,26970,21221,12671,2800,246,2800,1433000.0,110000,125,7531,10331,182400,1.0
712,11142,33122,85,7949,29690,26915,13205,2697,298,2697,1632500.0,127500,193,8445,11142,186300,1.0
532,3374,8723,11,2144,8586,6833,4170,858,61,858,309400.0,85900,27,2516,3374,130400,1.0
847,48675,137096,79,36773,136051,105028,55305,9588,931,9588,7404800.0,155800,882,39087,48675,91300,0.0
574,10077,26290,6,6291,25514,20530,12563,3423,276,3423,1738400.0,84900,410,6654,10077,117700,1.0
681,14549,39051,62,8511,38338,30633,18944,7274,1118,7274,4241200.0,114100,298,7275,14549,138900,1.0
954,154895,388182,13093,110226,382251,317353,191633,82003,8493,82003,79643100.0,205000,2318,72892,154895,77300,0.0
876,40177,113067,153,28819,111739,87428,45008,11602,1176,11602,9400200.0,143700,601,28575,40177,66700,0.0
486,3747,10044,0,2346,9017,8040,4968,924,34,924,290200.0,78700,168,2823,3747,78300,0.0
792,77130,198753,288,57037,196471,154567,87407,24990,2851,24990,18487600.0,138100,1188,52140,77130,125700,0.0
617,5980,16296,0,3483,14313,13692,7834,2006,29,2006,921100.0,74100,50,3974,5980,89400,1.0
538,7622,20388,13,4819,19059,15599,9185,2438,205,2438,989500.0,83200,82,5184,7622,54900,0.0
638,14961,41095,29,9834,37485,32344,18265,4530,687,4530,2336600.0,90600,821,10431,14961,173400,1.0
698,8710,22881,17,6099,22676,18348,10647,1815,193,1815,835600.0,114600,138,6895,8710,216800,1.0
520,6032,15952,14,3881,14713,12710,7807,1773,139,1773,725700.0,84400,156,4259,6032,78000,0.0
882,167188,446167,3247,128578,443233,356149,192159,68949,7481,68949,63392000.0,177800,2217,98239,167188,88700,0.0
730,8815,22271,80,6017,22144,17707,11413,2100,146,2100,882900.0,124500,137,6715,8815,86400,0.0
609,7500,20619,18,5171,19793,16278,8917,2748,196,2748,1224200.0,86900,161,4752,7500,105800,1.0
664,19435,53609,97,14189,53363,41853,22922,3934,373,3934,2013200.0,114200,175,15501,19435,82900,0.0
952,17930,51906,26,13812,46516,39718,22021,8531,1514,8531,7113700.0,116600,179,9399,17930,157600,1.0
580,5382,14631,57,3561,12833,11941,7281,1874,260,1874,802500.0,72700,57,3508,5382,92900,1.0
530,9174,24145,24,5742,23761,18972,14767,2371,205,2371,984600.0,84200,350,6803,9174,84500,0.0
570,7834,25667,60,5378,21250,20513,9870,1886,226,1886,881900.0,84800,195,5948,7834,97100,1.0
533,4073,11616,4,2719,9978,9094,4988,1786,166,1786,746600.0,64100,39,2287,4073,56300,0.0
1419,303676,780685,132660,237102,773850,661675,328662,193315,9872,193315,273410100.0,430900,5230,110361,303676,102300,0.0
1199,95011,213900,1358,60875,211589,184832,162629,20149,1812,20149,22017800.0,375000,2058,74862,95011,150400,0.0
1441,6139,17275,342,4116,17167,14369,17677,1369,143,1369,1494600.0,674600,68,4770,6139,218400,0.0
1455,593784,1582857,101119,472668,1567310,1300035,626351,222087,11565,222087,323765900.0,453300,5019,371697,593784,157200,0.0
802,55063,127751,822,37901,125512,108432,68928,17076,1368,17076,13366600.0,203300,914,37987,55063,203000,0.0
855,215903,557016,7341,159446,550584,454317,233550,80759,4876,80759,70124500.0,280400,2241,135144,215903,168500,0.0
866,178931,469188,4113,126830,463854,377991,193332,69456,3742,69456,59275300.0,198500,1534,109475,178931,130900,0.0
1185,184195,509114,14470,141380,502122,410793,204764,44374,3192,44374,50621900.0,344400,2332,139821,184195,57500,0.0
1135,291659,775860,22805,222547,768666,628016,311179,105652,4660,105652,116451700.0,373400,2234,186007,291659,103100,0.0
899,30512,70926,622,21872,70141,59708,33994,9488,496,9488,8213600.0,226600,368,21024,30512,65300,0.0
1450,262324,694389,51498,208315,685970,563983,275925,80443,4024,80443,116135200.0,433000,2719,181881,262324,75700,0.0
987,305975,818249,6750,233127,806244,662989,332532,107965,7125,107965,105545900.0,260800,4315,198010,305975,86900,0.0
1040,58782,161197,2302,43596,159836,140122,63436,19930,891,19930,20807400.0,272700,568,38852,58782,78600,0.0
1689,3761,10912,97,2909,10857,8914,12030,1323,463,1323,1935000.0,995900,176,2438,3761,180500,0.0
994,21190,51559,500,14229,50884,43529,56031,5416,3228,5416,5364700.0,252100,519,15774,21190,124200,0.0
1009,239791,619796,49408,172695,610390,502594,294858,126233,12815,126233,128523000.0,153200,6669,113558,239791,115000,0.0
673,8362,25801,65,5935,21825,21979,11334,2957,190,2957,2013000.0,131000,278,5405,8362,157900,1.0
1084,16498,37461,237,10817,37054,31332,20152,4899,198,4899,5144300.0,326300,378,11599,16498,118600,0.0
1197,92895,250132,2092,73459,247295,200369,98853,19868,1070,19868,23115800.0,281400,1082,73027,92895,44500,0.0
672,27759,72591,140,18242,67219,61337,33046,8649,963,8649,5764800.0,119900,677,19110,27759,91200,0.0
1661,111337,312495,6298,95442,309281,244975,116493,29255,2052,29255,47324700.0,439900,1090,82082,111337,179900,0.0
1385,306694,905161,74719,257658,898512,723402,330326,117181,9270,117181,165475200.0,272900,3840,189513,306694,172400,0.0
1579,205395,564600,10761,168328,543507,451557,220641,52819,3441,52819,80373500.0,346000,2678,152576,205395,75000,0.0
1224,312859,828637,19696,242275,820479,670033,336358,106897,8112,106897,133286600.0,249600,4187,205962,312859,56900,0.0
1338,90022,246105,3658,73785,243766,194819,94688,22727,785,22727,29896000.0,315400,1024,67295,90022,118500,0.0
1612,31462,90824,1365,25126,89636,71843,34785,5221,507,5221,7814000.0,347200,589,26241,31462,82300,0.0
646,11865,29516,82,8038,29037,24679,19211,2666,793,2666,1492200.0,167100,446,9199,11865,140600,0.0
938,7605,19666,140,5096,19316,16794,10662,2273,71,2273,2021300.0,237400,210,5332,7605,121100,0.0
1693,369242,1039198,84393,306246,1030760,822213,386587,126947,6349,126947,214305900.0,467500,3576,242295,369242,74300,0.0
1131,60432,167319,673,48066,165274,135084,63211,10985,704,10985,12226200.0,328100,676,49447,60432,20700,0.0
1325,17995,49071,550,13810,48540,39552,20885,3408,131,3408,4108900.0,343200,380,14587,17995,170400,0.0
1288,39276,110979,1180,31969,108087,86676,43834,11019,1115,11019,13983700.0,291500,561,28257,39276,120000,0.0
1618,54988,156021,4568,45680,152781,122589,58883,12483,988,12483,18409400.0,294000,685,42505,54988,159500,0.0
869,12940,32386,121,9094,31971,26313,16734,4422,294,4422,3541500.0,179300,207,8518,12940,156600,0.0
889,55999,149546,904,41316,141198,120112,61245,19882,1223,19882,17369000.0,205300,932,36117,55999,98400,0.0
1042,37415,102014,239,29140,100725,82053,42146,14706,2014,14706,15074400.0,171700,628,22709,37415,83100,0.0
1071,37076,102416,577,28901,101361,81142,42487,9966,941,9966,10292900.0,238000,692,27110,37076,122600,0.0
924,11996,32785,128,9177,32405,25875,13564,3456,405,3456,3194300.0,201200,228,8540,11996,101200,0.0
709,63035,154948,407,44699,153834,124478,77221,19341,1292,19341,13518300.0,140900,1857,43694,63035,111000,0.0
664,9325,20979,9,5294,20680,17538,16117,1631,95,1631,1062100.0,89600,229,7694,9325,98900,1.0
648,3728,8304,0,1941,8259,6934,9156,558,31,558,291500.0,83400,202,3170,3728,137800,1.0
723,13105,32915,26,8651,32681,26034,16860,3099,94,3099,2001800.0,96500,335,10006,13105,74500,0.0
733,6025,13821,6,3457,13633,11596,11178,1169,142,1169,779200.0,91900,177,4856,6025,174700,1.0
796,29163,77321,362,21702,76718,61870,31305,6035,644,6035,4872200.0,164700,381,23128,29163,89700,0.0
672,11269,25694,35,7495,25359,21259,14066,2493,258,2493,1519300.0,92100,228,8776,11269,125300,1.0
658,14736,41319,16,9640,37029,33930,16296,4018,238,4018,2595800.0,92100,452,10718,14736,124700,1.0
596,13880,31750,42,8798,31373,26389,21240,2550,330,2550,1327700.0,96200,513,11330,13880,89200,0.0
841,111894,286185,4010,83944,284407,235265,122718,46719,3808,46719,40895900.0,123700,1364,65175,111894,113500,0.0
756,38115,98585,62,27592,95362,79966,43690,8516,441,8516,6257400.0,124900,540,29599,38115,90400,0.0
689,12186,28800,29,8085,28496,23543,17408,2788,69,2788,1816700.0,126600,326,9398,12186,145800,1.0
550,10593,23389,5,6867,23086,19488,14279,2237,100,2237,1236100.0,95900,141,8356,10593,139800,1.0
700,23556,62956,61,15782,60500,50178,28426,5209,316,5209,3516400.0,101000,856,18347,23556,99100,0.0
730,5941,14982,15,3817,14875,11909,9173,1071,77,1071,668500.0,107100,145,4870,5941,100400,0.0
695,23831,60890,156,17271,60356,47472,27863,6192,356,6192,4029200.0,111200,475,17639,23831,94900,0.0
781,64387,159761,417,45291,158541,129569,71960,15363,829,15363,11551300.0,135000,1384,49024,64387,171400,1.0
673,29151,75190,104,20754,74699,59475,37028,6643,586,6643,4242400.0,123100,497,22508,29151,199400,1.0
1025,138947,361509,8388,110809,356361,300238,149651,55302,3593,55302,60706500.0,231500,1409,83645,138947,190200,0.0
610,6663,15238,29,3887,15095,12829,9833,1156,54,1156,609100.0,88900,134,5507,6663,132100,1.0
815,23539,59607,45,17034,59258,47678,27329,4637,254,4637,3506400.0,146300,329,18902,23539,243400,1.0
721,20686,51397,16,14785,51274,41979,26144,4040,83,4040,2382600.0,127600,741,16646,20686,133900,1.0
500,5315,11291,4,2872,11006,9675,9303,923,52,923,399800.0,76700,168,4392,5315,108200,1.0
722,6911,17462,90,4384,17273,14620,12416,832,187,832,548300.0,162200,250,6079,6911,159400,0.0
644,11131,23934,63,5514,23717,20787,24507,2054,331,2054,1350000.0,94000,372,9077,11131,85800,0.0
617,3282,8114,43,1869,8004,6855,6376,690,59,690,356100.0,105000,134,2592,3282,97200,0.0
826,673143,1763822,20345,462924,1751580,1389735,815472,254229,20418,254229,207210200.0,92400,18867,418914,673143,155300,1.0
708,16415,43543,62,11760,41414,34475,20782,4039,253,4039,2644800.0,97700,340,12376,16415,191200,1.0
917,36519,91222,390,26959,89528,74524,42991,8528,752,8528,7832900.0,183000,574,27991,36519,88800,0.0
738,61418,158989,234,42731,151193,128447,69438,16486,1637,16486,11939200.0,120100,1056,44932,61418,118700,0.0
570,5132,10836,52,3329,10739,9273,11098,1334,261,1334,770600.0,125100,151,3798,5132,124000,0.0
738,166838,410881,1862,110574,408548,327185,191958,49804,4110,49804,36645300.0,96500,3318,117034,166838,168300,1.0
701,9732,23133,66,5969,22964,19310,17996,1489,115,1489,924400.0,151500,400,8243,9732,128900,0.0
664,13157,36333,91,9032,35905,29839,18724,4144,552,4144,3164500.0,102400,457,9013,13157,174600,1.0
966,70831,186946,250,54930,186088,150503,75387,10362,569,10362,10520100.0,218700,985,60469,70831,103200,0.0
621,11457,25317,11,6132,24993,21588,20504,2278,162,2278,1331600.0,89000,311,9179,11457,119600,1.0
571,4555,11669,17,2120,11323,9957,15154,711,36,711,374900.0,80800,139,3844,4555,113500,1.0
691,9810,24432,67,6054,23191,20663,15781,1741,469,1741,987800.0,116200,605,8069,9810,84100,0.0
607,4074,9290,0,2083,9189,8080,9601,477,64,477,254100.0,93800,188,3597,4074,123500,1.0
564,5929,12854,2,3153,12714,11068,10462,754,48,754,402100.0,97800,114,5175,5929,115300,1.0
601,10990,25324,33,6015,25149,21121,17814,1806,40,1806,963600.0,100500,373,9184,10990,212100,1.0
762,102362,259830,1756,76968,257882,208822,111278,37178,2323,37178,30266700.0,146100,951,65184,102362,133200,0.0
647,15641,43181,138,10335,42952,36069,21350,4074,365,4074,2587700.0,114700,329,11567,15641,417700,1.0
669,26199,67145,151,17535,65202,56389,34733,7871,897,7871,5533200.0,142900,447,18328,26199,88700,0.0
670,18772,47899,33,12221,47376,38245,25225,3261,96,3261,1959900.0,104500,402,15511,18772,118500,1.0
587,9010,23221,33,5553,22961,18546,13718,1698,79,1698,866300.0,91400,145,7312,9010,142300,1.0
756,9880,24247,5,6655,24057,19706,14858,2020,80,2020,1396500.0,124100,239,7860,9880,92800,0.0
714,53528,134327,407,37207,132656,106793,60924,16182,1967,16182,11519300.0,102600,1260,37346,53528,93500,0.0
655,11348,25475,98,6987,25152,21641,18438,2080,265,2080,1182100.0,116900,372,9268,11348,111300,0.0
632,2253,6406,0,1347,5393,5482,4375,512,70,512,312000.0,83200,53,1741,2253,142200,1.0
828,236929,636376,6305,187079,632099,496116,251295,73640,3785,73640,62627600.0,153500,2242,163289,236929,141500,0.0
916,341532,864019,3181,252188,857360,700403,362764,92688,5262,92688,86478900.0,146700,5160,248844,341532,168600,1.0
731,78482,193803,384,52329,190465,156835,87208,22177,1670,22177,15947700.0,94900,2649,56305,78482,87100,0.0
705,27623,68617,107,19258,68206,55669,30240,6725,588,6725,4644200.0,111000,518,20898,27623,114400,0.0
567,3009,8580,0,1784,6746,7216,5278,502,84,502,299400.0,93100,66,2507,3009,219900,1.0
637,44070,105350,248,29040,104405,85937,48254,9639,594,9639,6101900.0,96800,2185,34431,44070,107000,1.0
702,11234,26160,99,7685,25894,21602,17596,2122,132,2122,1405000.0,158800,296,9112,11234,83400,0.0
823,44323,108586,525,32780,107901,88199,47348,12928,880,12928,10609100.0,142300,613,31395,44323,138100,0.0
558,15920,36395,87,10069,36001,29928,20349,3206,99,3206,1733900.0,105900,394,12714,15920,123400,1.0
512,6660,15577,27,4000,14144,13497,10797,1522,166,1522,751400.0,70100,256,5138,6660,132200,1.0
779,14496,32978,33,10389,32649,27204,21488,3848,409,3848,3034500.0,171100,217,10648,14496,102200,0.0
628,14004,38023,113,9283,34430,31864,21392,4203,467,4203,2528800.0,111100,327,9801,14004,146000,1.0
790,58652,149619,723,42109,148683,121024,63613,11633,1298,11633,8848400.0,149500,1549,47019,58652,173900,1.0
775,42556,114145,139,32258,113378,89262,50436,7683,251,7683,5363300.0,150600,734,34873,42556,55800,0.0
1003,499617,1241860,2872,385426,1235853,1005115,535380,146930,9658,146930,156520900.0,209800,6962,352687,499617,69500,0.0
702,17896,45909,24,12027,45501,36940,21828,4212,242,4212,2650700.0,105600,384,13684,17896,100200,0.0
611,3244,9254,58,1835,8268,7983,6652,435,66,435,241600.0,119000,76,2809,3244,70000,0.0
717,65216,172707,282,45888,167878,136567,73810,16750,1029,16750,11829500.0,105300,1330,48466,65216,72000,0.0
674,10176,26317,14,6790,26144,20891,16070,1970,96,1970,1069100.0,106300,174,8206,10176,46000,0.0
899,9022,21564,83,5797,21414,18403,15384,1179,412,1179,944900.0,248900,168,7843,9022,139800,0.0
805,33152,88205,165,23538,86704,71544,36448,5804,454,5804,4359600.0,151400,884,27348,33152,86100,0.0
597,12726,30597,99,7239,30258,25249,23285,2355,175,2355,1205100.0,85000,399,10371,12726,102500,1.0
643,17121,41535,87,11156,41212,33563,23010,3445,191,3445,1847100.0,101300,574,13676,17121,124600,1.0
519,1013,2136,0,584,2129,1812,2483,141,19,141,78000.0,95800,21,872,1013,57000,0.0
723,24898,70572,308,18877,70040,59721,28911,9591,1351,9591,7714300.0,128400,315,15307,24898,94800,0.0
447,2945,6072,10,1425,6009,5432,5679,347,13,347,159700.0,69500,114,2598,2945,165000,1.0
854,99721,280243,955,78737,278888,219345,106265,22515,944,22515,20207700.0,168000,952,77206,99721,245100,1.0
670,21624,53569,13,14607,52721,43712,24456,3897,278,3897,2427600.0,98800,795,17727,21624,94300,0.0
601,4979,10413,7,2351,10317,9246,11117,588,70,588,253700.0,96000,257,4391,4979,82500,0.0
568,12789,28730,76,8148,28378,23953,16031,2938,181,2938,1539400.0,94000,341,9851,12789,127800,1.0
731,22625,64147,116,16522,60417,51082,24838,4991,315,4991,3462800.0,117000,362,17634,22625,73200,0.0
674,7019,17358,48,4592,17306,14130,12259,1367,187,1367,858900.0,105300,182,5652,7019,94100,0.0
744,33986,83489,339,24076,82891,67449,36632,8195,542,8195,6363100.0,133000,545,25791,33986,80300,0.0
496,2852,6398,28,2099,6252,5113,3094,684,13,684,364500.0,114400,30,2168,2852,72600,0.0
495,1718,4017,0,1278,3995,3145,1944,309,35,309,164200.0,107300,9,1409,1718,77600,0.0
638,7709,15841,15,4481,15658,13553,16478,1345,119,1345,769600.0,169300,169,6364,7709,109000,0.0
771,23453,62040,329,18555,61544,48856,25587,7339,656,7339,6006400.0,173100,175,16114,23453,130800,0.0
585,6245,13966,11,4359,13679,11265,7062,1502,77,1502,826100.0,86500,138,4743,6245,136900,1.0
601,3713,8394,15,2527,8284,6811,4630,693,71,693,380000.0,107700,85,3020,3713,174900,1.0
606,8614,20825,216,6409,20478,16318,9934,1741,125,1741,989500.0,148300,117,6873,8614,96000,0.0
709,16765,42577,31,12824,41915,33391,19755,4384,235,4384,3102600.0,167000,244,12381,16765,181200,1.0
644,5082,10578,0,3381,10406,8879,7621,823,99,823,562400.0,165800,104,4259,5082,88800,0.0
689,12609,31564,96,9174,30971,24859,14833,3366,301,3366,2275600.0,152600,149,9243,12609,94800,0.0
631,3985,9433,13,2973,9199,7396,4270,1018,69,1018,587900.0,133600,53,2967,3985,113200,0.0
650,6123,15537,37,4853,15347,12212,7541,1306,75,1306,835900.0,118500,45,4817,6123,197400,1.0
679,5993,14888,23,4532,14761,11692,6565,1305,78,1305,844900.0,142800,128,4688,5993,94700,0.0
607,1576,3357,8,1027,3270,2745,2086,309,32,309,171400.0,79800,38,1267,1576,186100,1.0
616,4327,10936,3,3226,10805,8679,5039,1146,7,1146,696300.0,94500,125,3181,4327,97800,0.0
700,13489,33552,44,9721,33166,26262,19396,2951,240,2951,2027700.0,182100,96,10538,13489,186000,0.0
1031,499104,1224763,47574,402549,1215746,981256,525186,187587,9451,187587,202890700.0,245400,6377,311517,499104,86200,0.0
498,2264,5039,7,1504,4914,4114,3134,517,52,517,278000.0,97000,30,1747,2264,122800,1.0
592,10668,25243,22,7812,24904,20428,11647,2364,128,2364,1433400.0,135300,216,8304,10668,77600,0.0
594,5019,12040,29,3846,11852,9567,5693,1493,166,1493,877100.0,104500,105,3526,5019,112800,1.0
692,12965,28810,81,8543,28565,23297,25422,2501,65,2501,1459300.0,178700,210,10464,12965,83000,0.0
612,3428,8824,25,2263,8726,6907,4784,701,55,701,383400.0,122800,38,2727,3428,326800,1.0
779,19345,46138,250,14614,45330,36992,20458,4910,196,4910,4035200.0,191400,281,14435,19345,110600,0.0
648,8758,20743,42,5968,20636,16872,14760,1546,73,1546,944900.0,182700,166,7212,8758,152400,0.0
914,14571,38584,77,11399,38272,30104,15656,2682,21,2682,2441100.0,172900,89,11889,14571,68600,0.0
629,4350,10104,7,3249,9983,8094,5051,924,114,924,496700.0,114100,127,3426,4350,70500,0.0
593,8685,20084,118,6061,19869,16186,9989,2207,287,2207,1412000.0,112400,191,6478,8685,83300,0.0
704,15524,39386,272,11300,38978,30807,17058,4150,318,4150,2964700.0,114700,206,11374,15524,255300,1.0
690,7917,21854,37,5931,21565,16619,8616,2285,99,2285,1487700.0,118300,188,5632,7917,170900,1.0
713,10752,29057,57,7258,27445,23924,17427,2318,226,2318,1521500.0,151600,223,8434,10752,86300,0.0
884,59804,151685,4136,47936,149834,118059,63111,15640,1002,15640,14850800.0,188300,952,44164,59804,71400,0.0
616,4837,11437,18,3318,11246,8980,5426,1094,42,1094,650100.0,89400,76,3743,4837,165300,1.0
1130,47864,141463,1369,40949,139907,105816,49914,8145,424,8145,9195200.0,272000,389,39719,47864,135600,0.0
639,7690,20485,152,6283,20347,15542,8163,1348,27,1348,878200.0,167900,63,6342,7690,276100,1.0
694,8867,21490,204,6628,21311,17333,10135,1690,178,1690,1204600.0,167300,161,7177,8867,112200,0.0
594,4019,9229,32,2807,9073,7171,4488,1010,102,1010,619400.0,91200,75,3009,4019,79300,0.0
781,26314,63505,83,18057,62776,51090,41355,6394,857,6394,4852300.0,188100,492,19920,26314,89000,0.0
555,2733,6589,7,1856,6460,5236,3424,521,108,521,268200.0,88500,29,2212,2733,69500,0.0
924,46568,131130,555,38514,130369,97719,50705,8181,297,8181,7451200.0,211500,429,38387,46568,180900,0.0
829,12662,33477,86,10097,33280,26865,13330,3444,153,3444,2974800.0,178000,37,9218,12662,100100,0.0
737,16175,36891,49,11514,36494,29900,20769,4026,362,4026,3312000.0,197200,189,12149,16175,99300,0.0
580,2536,5923,0,1797,5877,4740,3305,525,37,525,313900.0,104900,30,2011,2536,38300,0.0
554,1891,4384,30,1343,4247,3536,2617,371,59,371,199900.0,71800,35,1520,1891,43800,0.0
779,10844,27810,54,8467,27649,21871,12583,1966,224,1966,1434900.0,190700,153,8878,10844,133400,0.0
567,1947,5500,29,1363,5468,3939,2777,592,58,592,337900.0,97300,21,1355,1947,100700,0.0
844,19871,54297,363,15558,52907,43152,21622,2896,86,2896,2610100.0,206400,356,16975,19871,93500,0.0
617,6310,15430,22,4485,15166,12195,7319,1439,337,1439,833200.0,97400,148,4871,6310,78400,0.0
603,4157,9930,16,2956,9762,7916,4771,919,79,919,483000.0,99100,38,3238,4157,75300,0.0
630,9777,24423,21,6600,24244,19231,13098,1781,64,1781,982500.0,141000,209,7996,9777,68500,0.0
689,17076,45847,385,12661,45331,35325,21185,5428,491,5428,3808700.0,153100,159,11648,17076,75400,0.0
815,25558,65767,385,20419,65163,54199,27707,9710,798,9710,8673100.0,170800,199,15848,25558,62200,0.0
677,8114,18709,14,6024,18497,15153,8693,1600,60,1600,1010400.0,164200,91,6514,8114,101200,0.0
560,3171,6840,8,2106,6720,5672,3685,619,28,619,279000.0,81100,85,2552,3171,98400,1.0
623,1533,3841,0,1079,3788,3180,3750,282,46,282,166100.0,128400,23,1251,1533,73800,0.0
656,24300,57790,118,16808,57121,46726,35966,5148,229,5148,3184200.0,170900,466,19152,24300,114500,0.0
611,7375,18898,52,5594,17788,15004,7948,1637,87,1637,1053900.0,147800,74,5738,7375,87500,0.0
730,85662,200294,1994,59844,197117,166367,104113,24924,1742,24924,19070700.0,146700,1322,60738,85662,97400,0.0
1034,126072,344861,6200,103458,342522,270872,130250,25113,1196,25113,26843000.0,205000,1209,100959,126072,183900,0.0
774,58657,155300,651,46548,154153,123512,63619,18364,757,18364,14171500.0,171300,558,40293,58657,90200,0.0
1063,158777,414655,7319,130813,412826,323723,163779,40719,2119,40719,44518200.0,238000,1010,118058,158777,98700,0.0
596,2484,5724,2,1700,5558,4547,3136,525,87,525,298700.0,95300,42,1959,2484,119700,1.0
621,10060,25789,20,7934,25490,19960,11219,3198,453,3198,2055600.0,135900,166,6862,10060,92300,0.0
565,3953,9397,8,2911,9334,7490,4807,749,79,749,414800.0,104500,81,3204,3953,58400,0.0
735,10116,25635,68,7320,25179,20030,12849,2642,156,2642,2014900.0,151400,147,7474,10116,95900,0.0
599,6219,14798,14,4484,14502,11802,7347,1275,166,1275,762300.0,100100,184,4944,6219,133900,1.0
1246,92005,250979,2898,74446,247714,195831,96467,17241,739,17241,21344100.0,264300,893,74764,92005,221700,0.0
710,13413,35408,16,9652,34371,28151,15923,2726,97,2726,1945600.0,162800,283,10687,13413,124500,0.0
690,2700,5270,33,1928,5230,4605,5968,675,49,675,420400.0,241400,86,2025,2700,288900,1.0
789,6353,15948,17,4617,15801,12933,7880,1176,33,1176,818400.0,147200,164,5177,6353,100600,0.0
595,5629,12776,54,3667,12606,10678,7903,1200,32,1200,721300.0,108300,264,4429,5629,41500,0.0
714,9164,23105,34,6794,22799,18128,10795,1953,115,1953,1312000.0,161600,146,7211,9164,222300,1.0
689,13327,32880,69,9684,32542,26047,16053,2756,130,2756,1725300.0,159100,132,10571,13327,244400,1.0
627,5883,14197,43,4442,13991,11252,6441,1553,217,1553,942900.0,133300,72,4330,5883,86300,0.0
796,22899,65251,68,17862,62714,52580,24788,5887,261,5887,4913500.0,188400,202,17012,22899,107500,0.0
758,14450,36612,120,10764,36230,28402,15503,3400,242,3400,2741800.0,154300,201,11050,14450,75100,0.0
963,31181,92024,605,26513,90017,70187,33249,5261,328,5261,5216900.0,204100,270,25920,31181,118500,0.0
635,5704,13626,29,3979,13332,10596,7050,1277,165,1277,746000.0,118900,54,4427,5704,68000,0.0
687,16005,39360,217,12723,38826,30375,16733,5007,220,5007,3756900.0,162600,100,10998,16005,149100,0.0
1003,35342,98799,1018,29912,98533,74893,36955,6647,412,6647,7066100.0,287200,507,28695,35342,130200,0.0
642,12958,30619,85,9290,30158,24653,14291,3000,277,3000,2001800.0,105100,171,9958,12958,158400,1.0
655,19356,45237,107,13111,44429,36873,27476,3797,240,3797,2343000.0,156100,291,15559,19356,80000,0.0
777,14760,35816,46,11415,35548,28324,15811,3202,248,3202,2328400.0,150400,270,11558,14760,79100,0.0
659,4898,10932,13,3455,10753,8869,6571,1017,43,1017,604800.0,163600,62,3881,4898,110100,0.0
934,208504,537893,17714,162525,533696,425484,218928,84782,4335,84782,82578500.0,208700,1671,123722,208504,135000,0.0
689,3630,9759,31,2742,9674,8001,4204,1217,224,1217,870500.0,150800,23,2413,3630,115100,0.0
615,4217,9448,10,2949,9321,7570,4848,1300,78,1300,737000.0,102100,78,2917,4217,95000,0.0
647,19228,50992,444,15075,50486,42785,21106,5766,686,5766,3744500.0,158400,185,13462,19228,86700,0.0
787,19145,46277,35,12725,46072,37346,24281,5069,960,5069,3753300.0,132800,531,14076,19145,80300,0.0
544,5044,14930,50,3132,13529,11789,6672,1314,19,1314,469500.0,76700,651,3730,5044,68300,0.0
414,1809,4631,31,1108,4531,3596,2160,685,28,685,181500.0,51100,0,1124,1809,65700,1.0
551,8204,21993,2,5576,21892,17097,9785,2124,194,2124,1023600.0,86000,436,6080,8204,160100,1.0
547,3198,8360,0,1815,8243,6694,4186,752,48,752,307900.0,77200,94,2446,3198,48200,0.0
747,28063,75835,108,20626,75208,59958,32822,12604,1442,12604,9123900.0,114700,436,15459,28063,137300,1.0
647,8813,23439,21,5787,23212,18922,10258,2176,172,2176,1252400.0,87000,127,6637,8813,75300,0.0
862,19767,52744,175,15272,52240,44120,24669,8216,1468,8216,7340400.0,177300,270,11551,19767,142900,0.0
389,437,1296,0,231,1046,1127,542,236,0,236,60300.0,50200,0,201,437,163600,1.0
847,50994,141314,190,36179,139838,111309,61679,15191,3436,15191,12096700.0,125100,1589,35803,50994,54100,0.0
750,22630,59558,5,16289,57746,46798,27157,8758,1148,8758,6462900.0,123400,852,13872,22630,170300,1.0
542,10477,30113,75,5722,29613,22630,13146,5332,797,5332,2502400.0,76100,244,5145,10477,92900,1.0
725,3983,10276,35,2865,10156,7562,4880,2489,493,2489,1662400.0,96000,50,1494,3983,103300,1.0
503,2882,9084,1,1512,8027,7394,5113,556,18,556,157000.0,60400,20,2326,2882,97100,1.0
597,3187,9106,6,1741,9052,7375,4272,997,34,997,316300.0,61000,0,2190,3187,101400,1.0
861,77630,200491,758,56947,193081,156906,91114,34346,5172,34346,29250300.0,144300,1668,43284,77630,64000,0.0
587,4798,11639,43,2806,11531,9583,5937,1206,116,1206,480700.0,80600,58,3592,4798,97800,1.0
661,9322,27215,31,6060,26635,21253,12064,1962,223,1962,1050900.0,86800,278,7360,9322,95200,1.0
709,29892,78221,0,20860,75234,61408,35152,10281,1346,10281,6761800.0,88500,553,19611,29892,90700,0.0
688,12806,34542,0,8472,33975,27034,15428,3215,348,3215,1669500.0,94800,151,9591,12806,103600,1.0
663,10096,28399,22,6814,28149,21707,11612,2919,264,2919,1366700.0,71500,99,7177,10096,94800,1.0
643,7411,18482,70,4873,18074,14729,8808,2070,67,2070,1090000.0,77600,118,5341,7411,115200,1.0
589,8642,27496,0,4958,23438,21428,10130,3289,266,3289,1374100.0,78700,363,5353,8642,103600,1.0
534,7174,18731,29,4667,18426,14459,9184,2113,217,2113,886700.0,72700,256,5061,7174,165200,1.0
527,2960,8306,0,1881,8234,6688,4229,511,242,511,242200.0,70300,360,2449,2960,86700,1.0
488,3097,7772,0,1970,7693,6015,4213,727,20,727,180000.0,74700,25,2370,3097,127100,1.0
578,8969,24296,58,5642,24009,18249,10732,4373,469,4373,2283800.0,62400,150,4596,8969,91900,1.0
680,6817,16547,24,4493,16455,13146,8320,1081,57,1081,481300.0,67300,86,5736,6817,171800,1.0
639,24663,68328,65,16885,67585,52726,28879,6759,688,6759,3608600.0,85600,442,17904,24663,96600,1.0
537,5903,14670,9,3285,14535,11524,7214,623,13,623,245900.0,101900,28,5280,5903,180400,1.0
601,14042,35967,23,9029,35523,28469,16538,3520,339,3520,1693300.0,87100,291,10522,14042,117700,1.0
674,10845,31075,10,7820,30829,23622,12694,2990,387,2990,1722400.0,102100,143,7855,10845,143100,1.0
608,8505,26915,43,5586,23227,21379,9693,3721,215,3721,1966600.0,71600,122,4784,8505,131200,1.0
525,3842,9868,19,2396,9783,7757,4831,979,35,979,407600.0,77400,29,2863,3842,123500,1.0
607,14675,37242,38,9664,36753,29410,17191,4372,503,4372,2216400.0,86100,411,10303,14675,133000,1.0
583,11509,31583,75,7063,29135,25197,14664,4320,161,4320,1870100.0,90800,266,7189,11509,93300,0.0
714,7681,19990,0,5085,19729,15778,9254,2167,468,2167,1291100.0,81200,173,5514,7681,114400,1.0
1000,61158,173267,120,49734,172433,133137,65118,16414,1080,16414,16032800.0,158600,1055,44744,61158,176600,1.0
666,6919,19172,23,4680,18927,14891,8627,1268,165,1268,600200.0,77600,22,5651,6919,90500,1.0
522,3119,8678,23,1883,8591,6617,3836,1304,52,1304,491800.0,64200,17,1815,3119,155900,1.0
550,5853,14617,24,3465,14429,11475,6959,1686,140,1686,762200.0,66600,60,4167,5853,120600,1.0
490,6280,18267,67,3215,18113,13881,8508,2452,314,2452,764400.0,50600,317,3828,6280,114900,1.0
643,4994,12574,98,2667,12470,10213,6714,707,33,707,246900.0,77500,89,4287,4994,66900,0.0
919,38405,102212,138,30962,101092,79029,41906,11271,1171,11271,10671600.0,213400,573,27134,38405,109000,0.0
616,9667,25466,47,6068,24698,20048,11932,2066,180,2066,913600.0,78500,208,7601,9667,94200,1.0
554,7606,19476,21,4801,19241,15659,10366,1835,333,1835,828800.0,82700,232,5771,7606,147100,1.0
523,7762,20458,82,4973,20336,16001,9350,1487,195,1487,590400.0,80100,0,6275,7762,123500,1.0
635,4174,13801,0,2909,10482,11331,5196,519,59,519,275400.0,80700,51,3655,4174,181200,1.0
637,13084,35981,56,9057,34688,28872,15318,3156,506,3156,1727900.0,94300,931,9928,13084,80300,0.0
580,3072,7537,0,1805,7376,5922,3602,1059,99,1059,461300.0,51400,47,2013,3072,73200,1.0
604,12267,33121,18,7427,32422,25705,14324,5467,303,5467,3052800.0,89100,172,6800,12267,87400,0.0
904,22022,60517,45,16836,59764,46910,24480,7015,1004,7015,5690600.0,169000,75,15007,22022,90100,0.0
686,32485,84840,93,23804,83914,65232,36521,10632,1143,10632,7158800.0,125600,450,21853,32485,67400,0.0
651,14962,39763,59,9181,39154,30362,18145,4730,353,4730,2602800.0,87500,514,10232,14962,59800,0.0
462,4296,14552,0,2471,10653,12337,5586,973,152,973,320100.0,63400,37,3323,4296,73400,1.0
609,5850,16114,43,3800,16028,12570,7338,1112,58,1112,562800.0,79700,70,4738,5850,68500,0.0
697,5979,17981,37,4034,17352,14474,7358,1289,110,1289,773000.0,113900,74,4690,5979,83300,0.0
666,18559,47510,0,12774,47059,37161,21983,6742,718,6742,4100200.0,114600,284,11817,18559,84600,0.0
612,6365,16089,0,4008,16035,12869,7968,1081,149,1081,502700.0,72000,102,5284,6365,119900,1.0
363,3695,10082,0,2318,9557,8290,4790,871,109,871,260100.0,70900,8,2824,3695,130500,1.0
498,4524,10309,0,2828,10186,8110,5519,1174,116,1174,510000.0,77900,8,3350,4524,92700,1.0
755,17393,49392,32,12684,49024,41468,21689,8137,1395,8137,6471000.0,146400,505,9256,17393,120800,0.0
645,10773,29437,63,7687,29025,22134,12457,2856,133,2856,1394500.0,80400,137,7917,10773,75000,0.0
744,20710,55049,0,13461,54137,43969,24956,4852,472,4852,3042800.0,122900,522,15858,20710,101200,0.0
636,8228,22936,24,5497,22216,17641,9489,2306,167,2306,1082600.0,80800,77,5922,8228,95000,1.0
535,4002,10942,0,2474,10743,8521,5199,1042,106,1042,413500.0,57400,47,2960,4002,78000,1.0
948,55226,149645,42,43169,144422,117810,59242,13674,1007,13674,12085900.0,158400,708,41552,55226,77700,0.0
685,10016,28333,4,7046,27857,22513,11319,2384,372,2384,1500800.0,107400,169,7632,10016,94200,0.0
664,18249,48002,1,11928,47575,36705,21617,8304,772,8304,4700100.0,74400,281,9945,18249,72300,0.0
718,4822,12659,24,3060,12648,9920,6100,1005,53,1005,552100.0,89100,83,3817,4822,89300,0.0
673,12449,34229,11,7930,34024,26456,14933,3388,700,3388,1861900.0,73800,629,9061,12449,104100,1.0
614,4476,12047,0,2872,11962,9544,5602,804,55,804,373400.0,81100,57,3672,4476,75300,0.0
559,5196,12426,2,3346,12241,9918,6457,1310,261,1310,596500.0,75200,58,3886,5196,78700,1.0
545,6454,17305,0,4145,17021,13526,7586,1882,219,1882,827600.0,63800,62,4572,6454,78800,1.0
421,3592,10221,0,2257,10062,8418,5130,666,149,666,140700.0,90900,82,2926,3592,50400,0.0
715,9778,28748,38,6432,28599,22645,12202,2159,162,2159,1205600.0,93800,184,7619,9778,80600,0.0
671,7220,23545,101,4675,23091,18018,9460,1065,214,1065,532000.0,98200,335,6155,7220,123100,1.0
626,7889,21379,26,5229,21023,16961,10232,2497,1212,2497,1263700.0,93200,57,5392,7889,81700,0.0
812,89153,243249,581,66142,240702,189381,104131,36319,3902,36319,28298600.0,109400,1688,52834,89153,109500,0.0
415,2453,7463,0,1353,7018,5785,3730,852,106,852,234700.0,57100,32,1601,2453,62200,1.0
635,8010,21437,0,5414,21267,16592,9466,1791,168,1791,843400.0,80300,157,6219,8010,146600,1.0
654,9927,28202,0,6618,27957,21829,11846,2755,493,2755,1602900.0,92500,176,7172,9927,110700,1.0
525,9533,25389,0,5831,25105,20194,11141,2778,294,2778,1299700.0,90500,110,6755,9533,97900,1.0
603,16204,40139,44,10467,39727,31533,18267,4996,462,4996,2695500.0,102200,214,11208,16204,117700,1.0
564,2403,6255,0,1447,6221,4912,3260,657,45,657,310500.0,90400,109,1746,2403,91000,0.0
612,3107,7581,4,2048,7444,6245,3958,663,34,663,327800.0,75700,57,2444,3107,164500,1.0
528,4997,12248,0,3419,12156,9656,6401,1347,86,1347,667600.0,80400,99,3650,4997,63500,0.0
754,19918,53941,32,15959,50163,43523,22064,8011,637,8011,6088500.0,147000,349,11907,19918,78800,0.0
633,13825,35488,11,9485,35130,27728,15926,4475,334,4475,2523300.0,112700,261,9350,13825,99800,0.0
585,3667,8959,5,2381,8850,7298,4629,989,48,989,483000.0,122800,41,2678,3667,135600,1.0
701,17330,44873,110,12298,44040,36428,20067,6783,748,6783,4424800.0,126100,405,10547,17330,98200,0.0
953,38147,96899,328,31004,95953,76471,40742,13277,1017,13277,13543000.0,204900,548,24870,38147,62800,0.0
636,24661,66248,19,16695,59613,53712,29675,7740,831,7740,4942900.0,110200,629,16921,24661,70100,0.0
780,139741,314867,13799,102288,310171,258575,176159,78891,8074,78891,63537500.0,123800,3435,60850,139741,244100,1.0
765,6874,17358,0,5138,17156,13965,7333,1556,17,1556,1029200.0,136400,118,5318,6874,192800,1.0
672,16550,42826,96,10618,42166,33950,19811,6071,636,6071,3866700.0,104600,344,10479,16550,106900,0.0
542,3618,8909,2,2277,8818,7113,4649,955,70,955,466200.0,81800,53,2663,3618,191100,1.0
539,3083,8300,0,1982,8097,6433,4193,657,78,657,289600.0,101100,72,2426,3083,131300,1.0
443,2111,4499,6,1448,4384,3698,2792,600,28,600,262400.0,93700,64,1511,2111,99300,1.0
503,1602,3976,0,976,3905,3149,2282,337,7,337,127600.0,72400,124,1265,1602,111900,1.0
514,5397,13807,0,3370,13750,10940,6618,1254,19,1254,558400.0,87800,182,4143,5397,78200,0.0
643,11311,28703,30,8030,28031,22730,12962,4072,283,4072,2586200.0,113500,687,7239,11311,62500,0.0
653,4844,11618,27,3306,11292,9231,6221,1349,194,1349,752100.0,105300,114,3495,4844,94700,0.0
564,5108,13610,16,3789,13472,10781,6600,891,256,891,473500.0,140500,56,4217,5108,98100,0.0
594,11773,29634,32,7989,29208,24101,13690,3615,251,3615,1931000.0,91300,237,8158,11773,73900,0.0
803,12032,33554,0,8486,33380,26331,15165,2437,456,2437,1921400.0,166100,322,9595,12032,134200,0.0
498,9048,24968,41,5719,23855,19934,11032,1640,120,1640,704300.0,90400,200,7408,9048,101000,1.0
625,9457,25763,0,6436,23867,20445,10872,3021,226,3021,1703100.0,95800,701,6436,9457,104700,1.0
762,30774,83028,46,23128,82583,63994,33273,7975,841,7975,6052100.0,154400,517,22799,30774,76700,0.0
622,3854,12564,2,2673,9060,10818,4323,1292,164,1292,753900.0,111600,65,2562,3854,81200,0.0
732,119989,286759,825,87939,282952,232676,130915,50275,4660,50275,37763200.0,136300,2075,69714,119989,88700,0.0
548,3528,8615,1,2450,8397,6733,4395,953,126,953,451300.0,72800,24,2575,3528,80000,1.0
648,13224,32655,44,9297,32169,26135,14804,3580,372,3580,2185800.0,122600,139,9644,13224,194800,1.0
483,4135,9396,0,2201,9144,7855,5655,1024,58,1024,415100.0,78500,141,3111,4135,64700,0.0
610,9595,25437,5,7012,25129,21471,11457,3905,437,3905,2649400.0,117700,83,5690,9595,145000,1.0
476,1669,4450,3,1112,4398,3413,2101,461,63,461,207800.0,72500,25,1208,1669,90100,1.0
475,1870,4883,0,1286,4786,3631,2367,534,35,534,255800.0,82000,127,1336,1870,90800,1.0
584,2283,6382,0,1552,6239,4984,3342,597,88,597,289500.0,77700,11,1686,2283,137200,1.0
703,16340,44855,0,9973,44391,37664,41590,3306,486,3306,2255900.0,176300,604,13034,16340,102000,0.0
577,2907,6807,2,1988,6714,5367,3495,724,11,724,361100.0,85000,223,2183,2907,134100,1.0
748,46009,118522,168,34135,117521,91819,51995,16302,1154,16302,11852300.0,112700,977,29707,46009,75400,0.0
824,83744,222639,204,65480,220994,175640,89979,16844,1227,16844,13597300.0,154100,1341,66900,83744,164400,1.0
522,3754,10078,2,2621,9883,8021,4537,1019,65,1019,485200.0,85500,250,2735,3754,107500,1.0
600,8137,22753,0,5686,22584,17490,9949,2384,133,2384,1154400.0,97000,134,5753,8137,119500,1.0
598,7309,18030,36,4834,17674,14280,8600,2736,225,2736,1412700.0,74500,298,4573,7309,144200,1.0
651,7529,19135,21,5492,18824,15019,8695,1771,147,1771,1103600.0,131900,82,5758,7529,100100,0.0
667,11717,31347,0,8232,30941,24848,13517,3911,309,3911,2635100.0,122600,261,7806,11717,85700,0.0
715,3994,10208,0,2821,10145,8277,5190,705,100,705,401900.0,126000,160,3289,3994,113700,0.0
673,8684,22859,13,6460,22593,18280,10011,1954,122,1954,1242000.0,129700,168,6730,8684,99800,0.0
723,12880,31529,0,7732,31200,26948,20866,2578,231,2578,1719100.0,160600,416,10302,12880,116500,0.0
562,2628,6361,3,1698,6216,5166,4035,566,32,566,242100.0,90300,71,2062,2628,77500,0.0
937,402307,999539,12881,306941,987505,803973,439403,122540,11348,122540,119420400.0,181100,5541,279767,402307,110300,0.0
624,15241,38858,27,10440,38369,30581,17164,4744,405,4744,2720100.0,103300,514,10497,15241,67500,0.0
630,13091,35398,56,8435,35100,28445,17574,3343,191,3343,1953300.0,112600,395,9748,13091,153900,1.0
527,4939,11942,17,3239,11822,9478,5602,1521,59,1521,772700.0,97500,21,3418,4939,98500,0.0
826,68898,174589,1006,55795,173247,142939,74840,31156,2424,31156,27277500.0,177800,600,37742,68898,91300,0.0
614,5879,13862,0,3484,13721,10907,7232,1742,52,1742,952900.0,92700,55,4137,5879,79600,0.0
627,29642,76749,125,22263,72770,61112,33043,9735,770,9735,6090000.0,154200,810,19907,29642,81300,0.0
616,9286,24387,24,5997,24074,19326,12033,2646,266,2646,1336800.0,116100,228,6640,9286,89100,0.0
624,6135,14769,11,4227,14507,12046,8202,1446,72,1446,787200.0,123000,168,4689,6135,80700,0.0
542,4062,10286,7,2443,9953,8426,5320,1131,158,1131,522600.0,83100,105,2931,4062,113900,1.0
630,5813,15025,26,3996,13830,12190,6784,1930,75,1930,1084000.0,106000,54,3883,5813,107000,0.0
492,6023,15319,53,3823,15047,12069,7671,1557,120,1557,745800.0,89000,120,4466,6023,129000,1.0
564,5373,15904,35,3893,14549,12366,6177,1248,107,1248,633400.0,118400,161,4125,5373,105900,0.0
458,4375,10779,84,2551,10653,8666,5486,994,172,994,436200.0,87200,174,3381,4375,78200,0.0
568,6875,17344,23,4224,17170,13251,8178,3244,345,3244,1666500.0,73300,124,3631,6875,107500,1.0
695,16031,42309,103,11540,41611,32975,18311,5251,351,5251,3508300.0,111400,442,10780,16031,123000,1.0
666,7185,17882,0,5117,17676,14438,8727,1641,4,1641,946500.0,148800,97,5544,7185,150700,0.0
559,3158,8273,23,1765,8207,6626,4164,894,28,894,354000.0,101400,102,2264,3158,117200,1.0
624,8348,24987,9,5699,22953,20030,10739,2050,173,2050,1224800.0,93800,128,6298,8348,84600,0.0
549,5173,13391,5,2938,13275,10875,6519,1209,48,1209,651100.0,101700,150,3964,5173,271900,1.0
535,12760,30905,17,8027,30233,23794,14423,4689,329,4689,2226200.0,69500,141,8071,12760,99400,1.0
736,40612,102413,261,29648,101627,81325,44462,10538,940,10538,7608200.0,156800,709,30074,40612,80800,0.0
666,9294,21834,4,5745,21577,17550,10963,2482,34,2482,1473300.0,92200,217,6812,9294,178400,1.0
610,3713,10144,0,2647,10019,8090,4580,896,68,896,488200.0,116300,40,2817,3713,160600,1.0
849,280174,688554,7047,211187,681702,541092,318178,115623,9827,115623,99318300.0,131500,4121,164551,280174,112300,0.0
650,14636,38131,11,10324,37556,29496,16681,4285,247,4285,2307100.0,98000,381,10351,14636,142000,1.0
638,9514,24947,7,6401,24636,19701,12886,2398,180,2398,1274900.0,126500,210,7116,9514,110000,0.0
991,15375,53132,132,12123,39627,42599,18911,7971,1406,7971,7119200.0,141700,508,7404,15375,157900,1.0
540,1956,4846,0,1152,4788,3908,2990,533,16,533,262400.0,84500,41,1423,1956,89800,1.0
761,22142,54308,154,15161,53887,44110,30535,8965,690,8965,6817500.0,124400,597,13177,22142,180700,1.0
566,9303,25714,18,5675,24269,20443,11724,2412,298,2412,1228500.0,105800,384,6891,9303,63100,0.0
737,33304,89425,315,24204,86315,70988,38674,12258,1856,12258,8744400.0,114800,1046,21046,33304,96300,0.0
629,3741,9046,2,2485,8853,7119,4648,931,37,931,499400.0,103600,80,2810,3741,78600,0.0
690,16105,44793,25,11826,42166,36440,18816,4542,229,4542,2951700.0,132500,337,11563,16105,58300,0.0
931,38706,101888,62,29417,101062,79397,41008,9494,696,9494,8558900.0,165800,521,29212,38706,75000,0.0
798,8185,20495,55,6254,20026,16287,8945,2038,112,2038,1537900.0,142000,108,6147,8185,73800,0.0
659,6410,17620,12,4616,16047,14210,7497,1843,120,1843,1106300.0,128900,117,4567,6410,63600,0.0
593,6156,16441,15,3721,16240,13063,7675,1650,90,1650,835400.0,107400,98,4506,6156,59900,0.0
575,2662,6688,13,1813,6535,5200,3210,733,64,733,365200.0,85600,50,1929,2662,50800,0.0
580,3983,9352,0,1951,9273,7978,6843,716,59,716,365400.0,90200,222,3267,3983,98800,1.0
828,18698,54800,37,14147,54290,42384,21456,4294,442,4294,3424800.0,154100,361,14404,18698,92500,0.0
586,5128,13916,11,3375,12182,11117,5717,2022,119,2022,1024300.0,73400,94,3106,5128,81200,1.0
556,3615,8676,0,2413,8572,6961,4857,924,37,924,460100.0,103100,271,2691,3615,103100,0.0
666,22151,58237,26,16395,57590,45945,24612,6284,382,6284,3864900.0,118200,216,15867,22151,124400,1.0
608,4075,9328,7,2076,9273,7788,5678,882,42,882,358000.0,91800,164,3193,4075,186500,1.0
636,6741,18517,12,4857,16253,14888,7903,1937,127,1937,1096300.0,106500,360,4804,6741,62000,0.0
993,142554,385115,409,115209,383181,303055,150013,28281,2576,28281,28882200.0,198500,1718,114273,142554,82400,0.0
527,1390,3669,17,835,3612,2863,2139,334,36,334,135100.0,82500,17,1056,1390,82300,0.0
564,4867,12226,5,3248,12042,9701,5990,1403,133,1403,714400.0,99800,12,3464,4867,104900,1.0
531,7488,18304,0,4526,18111,14222,8713,2377,123,2377,1060400.0,89500,153,5111,7488,78400,0.0
887,89709,236068,755,72722,234562,183996,96054,27742,2314,27742,25022500.0,160900,1587,61967,89709,187200,1.0
642,8170,20665,8,5707,20180,16246,9519,2590,144,2590,1553000.0,97100,103,5580,8170,142200,1.0
510,6087,15566,13,3759,15389,12403,7318,1808,67,1808,822700.0,107300,63,4279,6087,99600,0.0
628,8754,23010,74,6106,22549,18333,10150,2748,155,2748,1695800.0,96700,244,6006,8754,142100,1.0
627,8493,22744,9,6378,21906,19473,9685,3732,329,3732,2253500.0,117800,104,4761,8493,155200,1.0
503,888,2053,2,595,1996,1676,1275,217,22,217,85700.0,60600,9,671,888,155000,1.0
536,2842,7586,0,1782,7363,6063,4149,656,27,656,302800.0,81300,1,2186,2842,72300,0.0
583,4018,10111,75,2645,9936,7991,5014,1312,98,1312,614400.0,85100,66,2706,4018,71900,0.0
609,7774,20097,0,4069,19735,16158,15566,1915,96,1915,1125500.0,115600,321,5859,7774,131600,1.0
557,5482,13369,30,3087,13239,10857,8087,1278,91,1278,637600.0,72700,203,4204,5482,117200,1.0
584,4805,12347,42,2993,12262,9981,5886,933,81,933,453600.0,97100,73,3872,4805,102900,1.0
743,29613,78013,106,22247,76859,62972,33344,10260,870,10260,8089600.0,151900,682,19353,29613,93500,0.0
554,2446,6084,8,1780,5870,4805,3206,640,39,640,240300.0,70300,125,1806,2446,65400,0.0
614,13311,37558,60,9276,36636,28295,14650,3627,158,3627,2145000.0,122500,199,9684,13311,111900,0.0
518,2492,5335,10,1784,5248,4419,2965,731,52,731,352100.0,82000,59,1761,2492,139100,1.0
656,6704,16405,42,4461,16098,12873,7853,1765,149,1765,1001700.0,108300,150,4939,6704,92300,0.0
608,7982,18918,36,3882,18717,16120,14174,1487,111,1487,864900.0,114600,317,6495,7982,168300,1.0
723,4875,11895,30,3639,11674,9681,5683,1449,140,1449,982900.0,157000,125,3426,4875,114300,0.0
594,6208,16468,12,4609,16337,12466,7311,2336,86,2336,1365400.0,128000,122,3872,6208,189300,1.0
398,2290,5812,16,1516,5766,4593,2906,858,35,858,286600.0,123000,59,1432,2290,84000,0.0
590,365,790,0,272,790,656,456,112,0,112,48800.0,105500,0,253,365,68600,0.0
514,1791,4139,11,1142,4098,3311,2353,516,61,516,178700.0,117800,28,1275,1791,152500,1.0
551,764,1610,0,573,1579,1395,1048,276,19,276,45800.0,110900,7,488,764,105700,0.0
664,8244,19249,19,4289,19068,16155,11649,1694,328,1694,1052600.0,175500,361,6550,8244,180500,0.0
723,7552,16001,102,5169,15909,13358,9524,2197,156,2197,1483600.0,235600,55,5355,7552,72300,0.0
389,3203,11218,40,2118,10988,7937,4124,1351,214,1351,519300.0,116400,31,1852,3203,168300,1.0
480,2314,6646,22,1736,6550,4853,2848,948,89,948,375100.0,85800,26,1366,2314,113900,1.0
542,859,2245,9,611,2224,1896,1110,334,25,334,82700.0,108000,41,525,859,120200,1.0
683,1531,3646,117,974,3623,2938,2163,389,29,389,196200.0,225900,37,1142,1531,152600,0.0
833,4523,11405,4,3567,11405,8918,5157,1691,245,1691,1281800.0,213000,40,2832,4523,173200,0.0
676,2413,6040,7,1653,5976,4770,2918,731,25,731,401700.0,156600,66,1682,2413,140900,0.0
444,549,1325,0,342,1307,1053,679,62,22,62,24700.0,100700,22,487,549,138600,1.0
562,1871,5031,0,1319,4389,4162,2373,785,96,785,292800.0,125200,83,1086,1871,88500,0.0
511,4181,13677,0,2581,13551,9687,5382,1713,129,1713,854900.0,105000,79,2468,4181,104200,0.0
738,1241,2925,0,1019,2856,2248,1531,401,23,401,197900.0,154200,9,840,1241,154000,0.0
677,876,1788,0,556,1760,1454,1137,203,40,203,132800.0,123500,10,673,876,107700,0.0
697,3797,9342,73,2722,9296,7597,4878,844,110,844,534800.0,225200,63,2953,3797,106200,0.0
820,325,747,0,221,747,622,455,91,0,91,43900.0,98300,5,234,325,87100,0.0
527,925,1965,5,571,1965,1695,1326,263,14,263,75600.0,138500,16,662,925,212700,1.0
606,15256,34514,57,10679,33928,28225,17088,5118,382,5118,3326800.0,133800,241,10138,15256,99000,0.0
522,3984,9131,0,2409,8535,7919,5182,1193,53,1193,589800.0,116700,105,2791,3984,74100,0.0
714,4512,11625,0,3224,11458,9587,5104,672,31,672,387200.0,264000,73,3840,4512,177500,0.0
516,1309,3206,0,832,3178,2685,2835,361,68,361,145200.0,218900,57,948,1309,144400,0.0
600,720,1728,0,401,1707,1327,1048,139,18,139,37700.0,111900,0,581,720,75600,0.0
575,820,2108,11,506,2076,1621,1240,291,34,291,83100.0,89300,16,529,820,191300,1.0
734,3487,7902,17,2271,7842,6823,6999,804,531,804,394400.0,252200,98,2683,3487,112000,0.0
558,3205,9292,11,2469,9213,6980,4180,893,66,893,455700.0,118600,106,2312,3205,142400,1.0
712,1661,3568,7,1247,3519,2882,2150,400,26,400,210200.0,146500,17,1261,1661,86900,0.0
700,565,1320,0,329,1298,1086,811,96,8,96,28100.0,97900,0,469,565,191400,1.0
650,4045,9324,4,3237,9011,7415,4336,1237,57,1237,843300.0,154300,28,2808,4045,110900,0.0
661,3710,13290,18,2865,13160,9192,4737,1437,64,1437,806600.0,100000,5,2273,3710,80800,0.0
640,2405,5755,0,1618,5711,4762,2743,385,11,385,214100.0,195000,34,2020,2405,159900,0.0
665,11796,29518,80,7676,29358,23087,16811,3330,246,3330,1990900.0,224100,237,8466,11796,122600,0.0
819,27534,66290,97,20909,65677,53513,31250,8609,639,8609,7053500.0,220600,241,18925,27534,219600,0.0
591,2218,6081,0,1506,6012,4730,2678,615,71,615,259400.0,122100,63,1603,2218,82100,0.0
825,64020,156332,439,48810,154062,123106,68561,20483,1283,20483,18496400.0,210500,580,43537,64020,149400,0.0
792,47963,114231,1194,36977,113621,94465,52559,19729,1160,19729,16462700.0,259600,234,28234,47963,86000,0.0
756,16936,41387,0,10445,41146,34040,19788,4404,261,4404,3403700.0,246600,460,12532,16936,113100,0.0
609,3432,7561,18,2347,7448,6142,4870,899,29,899,393400.0,135600,117,2533,3432,87200,0.0
694,34383,81816,249,24448,78089,65244,38313,11824,840,11824,8339300.0,168100,444,22559,34383,87200,0.0
710,4953,11327,0,3450,11146,9251,5906,1487,32,1487,907700.0,133700,163,3466,4953,121500,0.0
500,451,1086,3,273,1086,889,846,86,4,86,18300.0,116300,11,365,451,78300,0.0
564,1694,4194,5,1027,4140,3525,2503,496,88,496,272600.0,159800,44,1198,1694,186100,1.0
481,206,453,0,148,453,396,307,72,7,72,14200.0,112000,0,134,206,93000,0.0
571,2400,6852,2,1742,5244,6027,3169,739,20,739,380000.0,141000,18,1661,2400,65500,0.0
633,4994,11414,2,2541,11284,9523,6754,1209,54,1209,628000.0,205000,146,3785,4994,142200,0.0
825,497,1121,0,339,1096,903,570,103,5,103,74900.0,110100,0,394,497,160900,1.0
948,40723,100733,126,33273,100355,82265,46600,15634,1022,15634,15248800.0,303700,497,25089,40723,140800,0.0
600,777,2000,0,526,1975,1551,1391,230,56,230,83800.0,136300,31,547,777,153500,1.0
754,4565,10466,53,3086,10380,8796,6543,957,136,957,677900.0,227400,30,3608,4565,98000,0.0
591,3978,9360,1,2767,9233,7998,5318,1355,97,1355,754200.0,192600,68,2623,3978,269200,1.0
798,38006,96147,367,27037,95564,76947,48154,10656,1099,10656,8443400.0,246500,968,27350,38006,206800,0.0
680,2073,4766,0,1243,4733,3851,2744,620,84,620,282200.0,161400,140,1453,2073,241200,1.0
581,897,1913,0,567,1861,1594,1297,176,10,176,67700.0,81800,15,721,897,138800,1.0
625,316,684,3,178,658,594,435,80,15,80,39200.0,85800,18,236,316,112400,1.0
690,2017,4903,0,1481,4741,3841,2445,578,24,578,272400.0,87400,47,1439,2017,255400,1.0
616,2814,7041,0,2079,6930,5748,3513,791,162,791,496300.0,114600,39,2023,2814,156400,1.0
699,6496,17045,5,5064,16761,13540,7063,1891,63,1891,1380900.0,159700,70,4605,6496,331500,1.0
531,293,643,0,201,643,526,402,89,14,89,37900.0,82300,25,204,293,286700,1.0
686,7427,20529,19,5917,20314,15164,7807,2536,65,2536,1604800.0,116400,0,4891,7427,448000,1.0
460,1499,3597,6,976,3517,2871,1910,298,23,298,102800.0,75600,49,1201,1499,355200,1.0
529,2748,6406,0,1968,6310,5134,3318,630,68,630,288900.0,78500,45,2118,2748,255400,1.0
613,1671,3803,0,1134,3734,3046,1938,326,19,326,133100.0,109900,45,1345,1671,349200,1.0
674,3400,8105,7,2497,7934,6453,4073,682,34,682,409900.0,111500,36,2718,3400,169700,1.0
559,2616,6264,0,1926,6165,4942,3023,595,41,595,323500.0,85000,69,2021,2616,476500,1.0
658,177,421,0,120,421,298,261,65,2,65,20600.0,101500,0,112,177,333500,1.0
608,4792,10836,0,3487,10714,8627,5626,1345,111,1345,703200.0,92800,114,3447,4792,348000,1.0
560,1367,3019,5,930,2956,2518,1727,225,48,225,102300.0,62000,75,1142,1367,295000,1.0
656,9255,21632,7,6702,21332,17316,10422,2917,422,2917,1861500.0,108800,31,6338,9255,302800,1.0
690,3722,9149,0,2921,9010,7262,4066,695,33,695,458600.0,136200,125,3027,3722,179300,1.0
546,245,537,0,170,537,449,420,45,0,45,10900.0,159100,4,200,245,208200,1.0
563,3308,7276,0,2278,7164,5903,3913,878,60,878,434600.0,75500,50,2430,3308,171700,1.0
713,2745,6547,0,2078,6474,5120,2953,839,48,839,588600.0,128600,53,1906,2745,237300,1.0
600,3989,8129,56,2734,8068,6692,5442,1297,39,1297,685700.0,108400,47,2692,3989,199600,1.0
643,14236,35062,66,11187,34438,27122,15200,4923,321,4923,3082600.0,126100,111,9313,14236,463200,1.0
686,1247,2904,2,863,2867,2283,1447,264,21,264,179400.0,105600,18,983,1247,384100,1.0
574,3870,9163,0,2851,8928,7219,4239,1144,89,1144,698300.0,120000,22,2726,3870,667400,1.0
747,8150,20953,4,6252,20683,16298,9525,1705,99,1705,1169800.0,159400,92,6445,8150,476500,1.0
729,14425,36509,27,10880,35917,28340,16393,4492,232,4492,3208300.0,116600,200,9933,14425,208500,1.0
680,3602,9409,0,2982,9375,7769,3869,1313,44,1313,853800.0,133000,35,2289,3602,389900,1.0
575,334,720,0,218,720,597,523,92,13,92,36900.0,72000,23,242,334,290100,1.0
684,1546,3688,6,1157,3627,2929,1947,515,77,515,331500.0,83200,36,1031,1546,203100,1.0
510,3662,8496,2,2650,8277,6758,4907,971,63,971,398400.0,85100,82,2691,3662,356700,1.0
683,15025,35569,53,11153,35153,27964,16745,5371,389,5371,3550300.0,130800,116,9654,15025,229300,1.0
601,3251,7829,13,2396,7715,6265,3782,820,98,820,483000.0,90900,13,2431,3251,452500,1.0
594,2985,7175,0,2246,7041,5622,3255,579,51,579,287500.0,102600,45,2406,2985,277200,1.0
592,579,1256,0,378,1256,1025,804,141,5,141,59500.0,103200,13,438,579,1056500,1.0
613,2885,6546,0,2017,6446,5222,3488,698,78,698,377200.0,91600,109,2187,2885,155700,1.0
779,9894,25513,13,7707,25028,20075,11391,1801,159,1801,1446600.0,166200,151,8093,9894,157400,0.0
652,3790,9039,0,2850,8890,7092,4239,1210,89,1210,730200.0,113200,176,2580,3790,112000,0.0
671,2307,5765,0,1721,5683,4484,2712,454,41,454,261900.0,87600,32,1853,2307,123500,1.0
507,875,2017,0,627,1978,1548,1146,280,10,280,82600.0,73900,35,595,875,112200,1.0
425,274,682,0,194,680,551,386,51,7,51,4700.0,55300,10,223,274,256300,1.0
549,1015,2436,12,644,2409,1933,1310,198,34,198,114900.0,69400,33,817,1015,88400,1.0
708,22817,61233,278,18672,60427,46337,24476,8739,382,8739,6236900.0,136500,275,14078,22817,113500,0.0
491,423,957,2,278,957,783,528,140,12,140,30600.0,77500,4,283,423,131500,1.0
659,6439,15875,12,4815,15632,12523,7139,1774,43,1774,1079200.0,130700,123,4665,6439,179300,1.0
605,4598,10870,0,3227,10616,8702,5311,1145,135,1145,638600.0,91500,55,3453,4598,101300,1.0
621,3508,8561,2,2664,8412,6667,4138,678,85,678,387400.0,113600,86,2830,3508,95600,0.0
632,3557,8972,0,2524,8896,7542,4240,1335,195,1335,815900.0,107500,79,2222,3557,122600,1.0
611,1869,5200,3,1302,3995,4376,2160,487,82,487,284700.0,82200,32,1382,1869,137600,1.0
685,4400,10012,0,3379,9914,7877,4984,1291,98,1291,871400.0,114100,80,3109,4400,146300,1.0
699,8898,23925,0,7178,23641,18053,10203,2951,157,2951,2001400.0,101000,152,5947,8898,86800,0.0
369,893,1958,5,579,1913,1613,1206,191,5,191,70200.0,96100,17,702,893,101400,1.0
644,192,432,0,126,432,345,244,64,7,64,30900.0,137500,4,128,192,167900,1.0
500,1553,3569,0,1065,3472,2873,1858,334,20,334,157700.0,80400,34,1219,1553,94300,1.0
522,1238,2704,0,729,2666,2208,1611,244,19,244,132500.0,71100,3,994,1238,97300,1.0
777,2351,6020,0,1881,5978,4627,2668,391,10,391,279800.0,111900,125,1960,2351,133300,1.0
614,1934,4252,0,1422,4208,3432,2305,549,65,549,328300.0,92700,6,1385,1934,137700,1.0
529,378,846,0,268,846,716,558,113,0,113,34000.0,104300,3,265,378,107400,0.0
572,1590,3469,5,1033,3418,2805,2398,364,6,364,181800.0,83200,14,1226,1590,115100,1.0
647,5623,13832,0,4222,13172,11098,6304,1650,129,1650,1022600.0,128400,105,3973,5623,146500,1.0
705,232,502,1,181,502,408,340,91,0,91,20200.0,85900,5,141,232,246000,1.0
755,18923,48834,45,15330,48238,38596,20064,6992,270,6992,5246900.0,161200,221,11931,18923,90000,0.0
591,3681,10616,0,3045,10531,7703,4172,1162,18,1162,668000.0,94300,31,2519,3681,134700,1.0
658,833,1901,0,618,1882,1562,1037,207,16,207,113100.0,76300,13,626,833,77800,0.0
627,1273,2860,2,854,2823,2288,1741,337,16,337,145100.0,58400,22,936,1273,102700,1.0
553,366,919,0,274,919,691,426,113,9,113,27000.0,110900,8,253,366,102700,0.0
684,12937,32875,14,10238,32585,25353,13719,3730,93,3730,2512500.0,136600,51,9207,12937,104100,0.0
612,2038,5244,6,1534,5150,4205,2719,401,37,401,223800.0,100200,57,1637,2038,124100,1.0
555,2337,5133,1,1624,4985,4168,2715,523,49,523,260100.0,67500,10,1814,2337,135000,1.0
575,4610,11200,3,3383,11037,8705,5459,1305,110,1305,735300.0,105400,49,3305,4610,157600,1.0
492,1475,3058,0,983,3013,2499,1876,400,37,400,153900.0,80200,20,1075,1475,106900,1.0
655,12659,31564,106,9432,31285,24959,13794,4014,272,4014,2586100.0,115300,153,8645,12659,91100,0.0
604,2306,5241,0,1546,5176,4189,2916,684,102,684,344400.0,70900,45,1622,2306,84400,1.0
787,120962,306357,1853,98821,301968,242856,127262,48317,2413,48317,39832800.0,162900,927,72645,120962,100000,0.0
596,2277,5357,0,1604,5255,4253,2664,504,51,504,268300.0,105600,28,1773,2277,102300,0.0
505,1985,4318,6,1308,4237,3566,2455,485,49,485,195600.0,62300,128,1500,1985,153800,1.0
528,655,1381,0,448,1343,1175,898,157,24,157,71400.0,83700,1,498,655,117700,1.0
513,300,728,0,218,728,582,405,95,0,95,29100.0,137200,3,205,300,149900,1.0
613,1113,2624,5,745,2616,2168,1566,259,47,259,138900.0,98200,19,854,1113,111200,1.0
510,1378,3048,3,977,2986,2482,1946,254,60,254,96200.0,85400,25,1124,1378,93500,1.0
871,213689,549706,3364,172811,543154,422816,229717,83107,6630,83107,75754200.0,155100,2193,130582,213689,135500,0.0
499,3798,8045,0,2657,7899,6575,4400,860,35,860,322200.0,69300,31,2938,3798,105300,1.0
609,2656,6385,0,1888,6378,4996,3047,617,74,617,371500.0,119600,30,2039,2656,125100,1.0
598,4569,10293,21,3376,10130,8058,5234,1281,83,1281,781000.0,102900,84,3288,4569,83800,0.0
556,2172,4814,0,1530,4731,3870,2726,613,43,613,317900.0,65300,49,1559,2172,163500,1.0
621,885,2019,12,637,1983,1687,1286,269,6,269,131900.0,116300,0,616,885,157700,1.0
723,5073,14325,8,3888,14043,11267,5818,1610,65,1610,1239300.0,95000,52,3463,5073,100500,1.0
943,63851,175188,144,54486,171101,131124,66943,19388,1344,19388,19272200.0,173900,559,44463,63851,97700,0.0
578,2142,7055,33,1599,7005,4791,2435,858,60,858,459800.0,79100,79,1284,2142,115300,1.0
706,8133,20414,17,6197,20234,16093,8508,1910,59,1910,1392600.0,182400,109,6223,8133,102700,0.0
475,905,2049,0,573,2022,1661,1393,165,22,165,44100.0,63800,33,740,905,162900,1.0
699,2652,5792,0,1994,5740,4628,3176,1013,51,1013,444200.0,119800,19,1639,2652,147300,1.0
719,15090,36576,31,11470,36025,28818,16699,5443,278,5443,3863700.0,119600,210,9647,15090,110500,0.0
590,2443,5603,2,1748,5374,4610,2927,612,71,612,317000.0,76100,129,1831,2443,69900,0.0
934,30529,76109,153,22842,75355,64060,35304,9076,436,9076,8439300.0,188700,523,21453,30529,178300,0.0
1007,57247,147958,245,43492,144508,122595,64449,16631,1137,16631,16305900.0,226700,729,40616,57247,66200,0.0
904,34856,89280,659,25835,88326,76118,52347,11054,949,11054,10460700.0,215600,666,23802,34856,132400,0.0
1164,119955,302479,1351,96219,300188,249570,130187,27930,1148,27930,33335000.0,295900,1183,92025,119955,83000,0.0
933,24579,60383,11,17713,59629,50354,38148,5960,358,5960,5545900.0,220400,558,18619,24579,66900,0.0
893,17780,43073,71,13241,42581,35666,22566,4726,357,4726,4058400.0,171100,342,13054,17780,79400,0.0
1132,158139,406371,1788,126851,402033,330660,169289,54001,3014,54001,61083800.0,256300,1187,104138,158139,81000,0.0
1018,48543,126552,1327,37914,125124,104864,53109,16698,1182,16698,17541700.0,220900,491,31845,48543,113900,0.0
711,13879,32119,11,9293,30072,27526,21491,3997,266,3997,2661100.0,123200,309,9882,13879,167600,1.0
920,21203,47524,72,14203,47059,40854,40729,4333,168,4333,3727400.0,227600,520,16870,21203,128800,0.0
792,9734,24022,0,6735,23152,18891,10867,3473,300,3473,2449300.0,169100,57,6261,9734,71500,0.0
1094,20376,47632,33,13176,47330,40149,24063,6233,179,6233,6788400.0,311400,264,14143,20376,138500,0.0
625,2183,5887,300,1651,5845,4422,2688,407,43,407,240500.0,151900,58,1776,2183,113100,0.0
648,2018,6661,22,1451,4714,5706,2469,603,109,603,412700.0,101100,37,1415,2018,63300,0.0
497,494,1102,0,277,1097,920,992,225,77,225,85200.0,73500,10,269,494,95400,1.0
695,765,1728,78,569,1723,1393,1167,237,17,237,110400.0,83100,7,528,765,68200,0.0
832,6261,17088,1206,5081,16871,12924,7455,1449,133,1449,1066600.0,163500,142,4812,6261,75500,0.0
518,1859,4471,0,1159,4399,3647,2770,649,166,649,288100.0,90900,64,1210,1859,79200,0.0
696,3343,9858,58,2383,8381,8032,4512,792,109,792,506300.0,130600,183,2551,3343,110500,0.0
904,17882,52377,3875,15216,51729,39478,21075,5255,842,5255,4576500.0,198100,160,12627,17882,69400,0.0
592,1930,5203,0,1076,4696,4386,2661,594,115,594,298600.0,132900,15,1336,1930,100900,0.0
792,18077,43296,164,9635,42853,36802,22348,5548,336,5548,4143700.0,125100,387,12529,18077,77800,0.0
747,1665,3891,29,1065,3860,3507,1969,285,0,285,221000.0,187100,86,1380,1665,64300,0.0
947,173519,445551,4089,130816,442940,358173,191068,73382,5172,73382,74616700.0,268100,2954,100137,173519,90100,0.0
1048,749858,2112436,35708,573727,2088806,1667625,877617,354657,42970,354657,385638700.0,212300,13820,395201,749858,72200,0.0
868,22158,54219,62,15238,52287,44354,23722,9967,538,9967,9228400.0,217400,105,12191,22158,105100,0.0
919,20127,52303,12,13946,52010,42077,22979,5879,317,5879,5151000.0,158000,643,14248,20127,72200,0.0
1315,232482,627551,24400,179605,623613,507976,260524,60922,3175,60922,82770000.0,396200,4333,171560,232482,126800,0.0
1191,129546,373362,13974,100482,367599,302590,144385,46358,3397,46358,56925300.0,281900,2132,83188,129546,106500,0.0
1244,53618,143570,1282,42788,142397,117479,62275,9276,807,9276,11188900.0,264100,1167,44342,53618,195400,0.0
1003,50596,154952,1025,36608,143496,122276,56332,18351,903,18351,17734900.0,160500,722,32245,50596,269500,1.0
1499,115970,333316,8603,94877,330448,266861,125762,27782,3159,27782,42328700.0,412800,2294,88188,115970,231900,0.0
1107,280327,800401,76502,214770,788754,630252,315186,155475,14137,155475,172618800.0,362300,4433,124852,280327,582400,1.0
1368,223135,589699,4564,147424,584418,465057,281171,44565,1678,44565,59181100.0,267900,4472,178570,223135,184200,0.0
1070,100660,272926,7959,74708,270265,220413,127809,32815,2503,32815,34492500.0,219000,2002,67845,100660,549900,1.0
1134,104810,291372,3137,82508,290110,233391,112516,21379,1923,21379,24592500.0,213800,1319,83431,104810,568700,1.0
1384,283794,837288,38337,228889,828230,675067,299753,103310,5585,103310,142551100.0,329000,3047,180484,283794,177100,0.0
981,24038,63776,302,17282,62626,51479,27584,6885,541,6885,6502500.0,185800,791,17153,24038,326400,1.0
1238,162440,510563,21294,125143,506947,401342,176843,75539,3647,75539,90788600.0,333200,1775,86901,162440,707800,1.0
1086,39861,94549,834,26891,92434,79862,99014,8961,5610,8961,8941900.0,295500,1783,30900,39861,330100,1.0
1018,187012,510996,17960,142296,505446,406282,205883,62004,3511,62004,64242000.0,193500,2390,125008,187012,603700,1.0
1419,337819,937920,68921,268195,931733,761286,355632,119753,5041,119753,177689300.0,451200,3908,218066,337819,477200,1.0
1219,187916,557320,31709,149861,552755,440546,201442,77154,3877,77154,95001100.0,351800,3490,110762,187916,173200,0.0
1056,41385,107088,579,31783,106181,87767,45398,11862,640,11862,12337600.0,256700,1213,29523,41385,526300,1.0
1286,252352,679756,146999,204379,675541,554677,277742,173236,12522,173236,245736100.0,349500,3272,79116,252352,395500,1.0
1388,46822,125717,1683,36809,121490,103806,49984,7637,642,7637,10355600.0,393800,822,39185,46822,296600,0.0
1263,164404,449192,7900,129834,434992,364927,178178,38847,2926,38847,50031700.0,245300,2237,125557,164404,349000,1.0
1420,180124,498847,13751,145667,494902,403879,191642,44927,3369,44927,66052700.0,438100,2123,135197,180124,356800,0.0
778,41999,128221,176,31678,126898,96817,50716,11352,1390,11352,8515900.0,143300,849,30647,41999,711000,1.0
524,3085,8447,0,1526,8404,6731,5659,970,57,970,421700.0,72200,25,2115,3085,543400,1.0
727,7902,19497,8,4397,19346,16339,17976,1712,753,1712,1043100.0,171900,885,6190,7902,330600,1.0
727,23343,65454,129,16619,64465,50052,27085,7473,1203,7473,4949000.0,106400,555,15870,23343,913000,1.0
831,22029,69505,124,17305,67623,50611,25937,7030,1160,7030,5268500.0,118500,322,14999,22029,959200,1.0
987,61651,147514,950,41667,145821,122691,72746,18305,1605,18305,18125200.0,277700,1093,43346,61651,186300,0.0
530,1424,4216,14,890,3601,3424,2343,487,21,487,216500.0,89500,27,937,1424,242500,1.0
568,5400,11254,4,2513,11005,9638,8490,1381,301,1381,698000.0,99600,405,4019,5400,204000,1.0
591,4698,17098,22,2484,17002,13343,8179,1125,494,1125,638600.0,103000,288,3573,4698,537900,1.0
762,7125,19313,0,5142,18717,15000,8434,2767,382,2767,1916000.0,114300,260,4358,7125,222000,1.0
1004,7525,18031,296,5803,17947,14444,8370,1982,253,1982,2085000.0,285300,68,5543,7525,248100,0.0
597,12852,39455,154,6634,39215,31183,20001,3004,462,3004,1646300.0,167100,474,9848,12852,234900,1.0
647,11041,28203,44,5693,27631,23514,15873,3271,327,3271,1705200.0,132900,352,7770,11041,205200,1.0
818,23657,65130,148,16441,59882,51341,31561,8488,1139,8488,6727500.0,106300,928,15169,23657,652900,1.0
781,26985,75845,238,17850,74349,59753,30894,5267,612,5267,3837300.0,133100,634,21718,26985,297700,1.0
810,5598,15534,0,2950,14921,12636,7990,1111,164,1111,653100.0,111700,257,4487,5598,260300,1.0
834,263551,674855,5572,192992,667841,539287,291099,97943,10042,97943,85888800.0,189700,4686,165608,263551,994100,1.0
611,9068,27049,26,6162,25336,21252,11306,2618,192,2618,1422900.0,89800,309,6450,9068,278900,1.0
671,666,2016,0,381,1989,1613,1143,223,0,223,94100.0,67700,49,443,666,313800,1.0
430,1253,4426,0,565,3783,3703,2498,420,13,420,144300.0,81100,16,833,1253,296400,1.0
840,1433,3547,0,506,3539,3140,4000,102,27,102,72800.0,164600,227,1331,1433,155500,0.0
526,1761,4446,0,1127,4351,3555,2438,479,38,479,220600.0,81200,66,1282,1761,295500,1.0
549,9088,24319,62,5584,23948,18554,11213,3476,330,3476,1802300.0,83800,159,5612,9088,357300,1.0
651,19764,72849,125,12863,72505,53706,26163,5633,835,5633,3122900.0,62800,204,14131,19764,80100,1.0
1057,49265,138815,633,35553,137964,108945,55163,9450,680,9450,9809700.0,183300,1310,39815,49265,157200,0.0
716,12603,32809,44,7589,32624,27286,20721,3237,1089,3237,2186100.0,218400,251,9366,12603,82200,0.0
679,11879,28382,38,7224,27951,23018,14960,3294,303,3294,2151000.0,125300,306,8585,11879,335900,1.0
836,18470,50283,17,14009,47717,38191,21067,7806,904,7806,6223700.0,131200,378,10664,18470,337400,1.0
589,5591,12522,0,3256,12012,10460,10207,1823,595,1823,972700.0,105900,304,3768,5591,140800,1.0
841,21273,56793,117,16491,56148,43524,24011,6261,502,6261,4713800.0,143100,280,15012,21273,337900,1.0
525,203,546,0,105,544,451,564,54,3,54,19900.0,67800,2,149,203,339400,1.0
688,1513,4605,0,753,4605,3842,2765,360,37,360,159500.0,109100,70,1153,1513,366800,1.0
781,12539,31611,137,8387,31535,26655,17465,3068,202,3068,2252900.0,143300,236,9471,12539,293600,1.0
1133,495356,1455846,345297,352343,1434422,1128491,524488,397698,11646,397698,429787700.0,371800,3360,97658,495356,419900,1.0
823,185840,467669,6245,136276,462658,378406,206707,65234,6364,65234,54690200.0,139400,2816,120606,185840,203100,1.0
734,22535,53955,133,15632,53200,44129,29004,6450,485,6450,4537400.0,107600,516,16085,22535,87300,0.0
762,31680,81224,267,22499,76759,68228,36352,10138,555,10138,7576200.0,129000,442,21542,31680,117600,0.0
750,13536,34843,56,9564,32036,28610,16293,3624,242,3624,2546000.0,98400,142,9912,13536,113200,1.0
908,64456,159800,2281,48769,158043,131288,72663,23578,1233,23578,21654400.0,183400,768,40878,64456,273000,1.0
1334,34316,99464,4254,27250,98891,81754,38578,6215,477,6215,8392500.0,357700,453,28101,34316,538600,1.0
670,18956,51054,149,12361,46282,42189,25582,5136,271,5136,3275900.0,102200,384,13820,18956,214000,1.0
657,25187,62943,282,17841,62282,51266,33726,7134,520,7134,4411500.0,95800,531,18053,25187,170700,1.0
837,44269,109491,288,32238,108600,89452,50074,11880,977,11880,10417900.0,156500,475,32389,44269,623400,1.0
1456,777904,2339280,572769,607606,2324280,1915787,850422,431863,16346,431863,611285100.0,481300,9269,346041,777904,104000,0.0
691,40351,97539,219,28071,96379,78595,49363,11395,717,11395,7602700.0,95300,596,28956,40351,71700,0.0
713,1095,4646,4,685,4612,4079,8885,168,21,168,99600.0,164000,82,927,1095,115900,0.0
823,23988,62183,237,16960,59170,51620,29367,6557,400,6557,5248500.0,144900,387,17431,23988,195400,1.0
631,52983,130846,151,35437,128249,106962,67422,15885,1739,15885,9833900.0,85800,1148,37098,52983,336200,1.0
1314,944650,2635121,732044,711444,2623350,2088858,1028383,660898,29659,660898,888376600.0,623900,9988,283752,944650,208300,0.0
1615,758345,1653877,525683,565688,1643228,1437692,872645,575892,35689,575892,1008327500.0,915300,10632,182453,758345,491100,0.0
695,19996,49322,193,14054,48942,39993,22427,4574,303,4574,3144400.0,113000,290,15422,19996,462200,1.0
715,31428,78319,338,22604,74877,64592,36882,9173,671,9173,6445900.0,120000,566,22255,31428,147100,1.0
683,16214,41584,91,11480,38971,34333,18528,4048,104,4048,2615000.0,93600,315,12166,16214,171600,1.0
1046,93129,226632,924,71892,223481,185143,103766,26505,1464,26505,29173200.0,243600,874,66624,93129,510600,1.0
1420,99935,325027,12436,79617,322811,245070,105530,31113,1882,31113,44915100.0,425100,1165,68822,99935,563000,1.0
886,25470,61481,705,18116,59819,51694,33252,7041,448,7041,5978500.0,224600,691,18429,25470,357000,1.0
742,10236,26845,34,7293,26485,21272,15519,2249,253,2249,1616000.0,121700,188,7987,10236,219000,1.0
669,87978,212675,820,61270,210660,174916,100104,25090,4935,25090,16954300.0,114800,3972,62888,87978,155400,1.0
1444,345885,975321,106041,267171,962824,781159,373236,133154,9112,133154,194168500.0,513300,5343,212731,345885,183900,0.0
696,19098,45950,281,12138,45478,39157,31524,5090,381,5090,3406900.0,138000,495,14008,19098,284800,1.0
798,15257,38233,59,10543,35897,32769,26114,3657,356,3657,2886400.0,146900,498,11600,15257,214400,1.0
732,19700,49500,259,13754,48717,39440,23480,6135,542,6135,4106800.0,99900,373,13565,19700,94100,0.0
1663,444136,1363069,111697,349392,1353154,1102475,471031,86154,5056,86154,139244800.0,460700,8955,357982,444136,254300,0.0
1229,166150,475948,62618,123850,471955,383590,179179,50722,3765,50722,60739800.0,460200,3350,115428,166150,138700,0.0
723,41638,110817,207,28073,107198,90701,52908,11449,704,11449,8312600.0,88000,898,30189,41638,327800,1.0
741,7444,18112,64,4926,17876,15019,9691,1756,284,1756,1183300.0,114700,51,5688,7444,382800,1.0
1055,38986,104415,3192,29207,103532,90533,42727,17356,1244,17356,19617700.0,190100,423,21630,38986,246700,1.0
881,27249,64701,288,19099,64154,54254,39559,7644,841,7644,6737200.0,192800,426,19605,27249,251300,1.0
645,20373,48763,80,13845,48177,39777,25269,5108,361,5108,3091100.0,95900,675,15265,20373,237700,1.0
742,17925,48334,114,13607,47867,40101,20724,6327,574,6327,4685700.0,113900,219,11598,17925,198000,1.0
1174,107384,295685,7189,81420,287723,245245,120136,33120,2453,33120,38594700.0,275200,2496,74264,107384,284900,0.0
966,43206,116567,168,32548,104191,90892,59547,19194,2141,19194,17403100.0,149300,1198,24012,43206,254500,1.0
872,300496,748680,10915,220462,741530,608192,325818,108715,9767,108715,98791500.0,142300,2956,191781,300496,248900,1.0
735,90472,232324,983,63098,224652,188425,104998,30201,2621,30201,22209700.0,120000,1473,60271,90472,568400,1.0
1646,489328,1497595,46030,379970,1483523,1210227,574342,96263,6940,96263,150265800.0,379400,8509,393065,489328,207600,0.0
1053,69662,180129,2043,50571,175816,151327,84647,21319,1506,21319,21599700.0,221600,1626,48343,69662,82900,0.0
634,15686,40886,71,11231,37617,33691,18085,3789,144,3789,2212000.0,108500,216,11897,15686,109800,0.0
764,34664,86883,705,24280,83346,70073,38761,11055,1010,11055,8575800.0,105500,474,23609,34664,166900,1.0
755,24432,64373,70,17544,61781,54241,27427,6544,388,6544,5086300.0,125000,315,17888,24432,97200,0.0
748,45881,119833,422,33011,119166,97231,54304,12579,1114,12579,9172700.0,97800,954,33302,45881,177400,1.0
808,23627,60750,523,16296,60089,52019,31098,6074,587,6074,4957900.0,141900,339,17553,23627,174400,1.0
876,17106,47791,231,10944,44874,40655,29625,4146,579,4146,3379700.0,176100,472,12960,17106,105900,0.0
742,36578,91442,165,26033,90522,73834,41561,8469,595,8469,5936600.0,118900,672,28109,36578,167200,1.0
969,125376,308580,8834,94923,304767,257424,140088,54102,3980,54102,53060400.0,214400,1456,71274,125376,218100,0.0
633,18124,47400,106,12343,46918,38905,26324,4661,395,4661,2852800.0,73300,322,13463,18124,183000,1.0
734,78821,196124,2514,53966,193241,162540,90727,27052,3205,27052,20876000.0,113100,1156,51769,78821,135400,1.0
626,31723,78175,106,21391,77388,62552,41431,9106,799,9106,5561100.0,86500,703,22617,31723,165700,1.0
778,386371,923995,15715,276559,912268,756762,425716,135159,7706,135159,106555100.0,139900,3616,251212,386371,76400,0.0
755,26307,71760,111,18808,71200,59377,32137,6322,616,6322,4367600.0,132800,814,19985,26307,82000,0.0
894,53825,155239,2744,39290,153486,125442,69062,17306,1508,17306,15316300.0,164100,1078,36519,53825,185800,1.0
860,27679,75783,632,19059,73419,61486,50232,9158,1347,9158,7315400.0,167900,1241,18521,27679,98800,0.0
748,23951,58537,67,17592,58079,48038,25712,6582,444,6582,4585400.0,111900,390,17369,23951,264400,1.0
732,9338,25083,0,6238,24730,20155,13771,2142,209,2142,1533700.0,128900,132,7196,9338,287700,1.0
1187,126460,378174,9314,99061,369083,292199,141493,40011,2204,40011,48335500.0,260300,3458,86449,126460,224000,0.0
640,13273,35445,4,8164,33477,28246,15278,5038,212,5038,3078700.0,85200,235,8235,13273,268200,1.0
822,20331,53421,414,15083,53092,47373,33272,8355,1290,8355,7174900.0,240700,487,11976,20331,172600,0.0
689,21207,52300,17,13115,50897,42300,25883,7819,455,7819,4757000.0,86500,232,13388,21207,200000,1.0
774,63035,157844,171,46083,156660,126150,69049,21822,1868,21822,17030700.0,145500,629,41213,63035,139500,0.0
756,1539,4090,0,935,3480,3566,2152,376,9,376,165700.0,113100,44,1163,1539,71100,0.0
652,7348,21059,0,5061,18864,17057,8289,2254,107,2254,1280000.0,85700,115,5094,7348,66600,0.0
721,26288,59854,117,16470,59410,50372,35295,7427,604,7427,4923100.0,175900,537,18861,26288,246500,1.0
559,6390,15155,0,3826,15036,12707,8800,1311,233,1311,714700.0,140600,214,5079,6390,99000,0.0
737,5903,14370,0,3804,14100,11704,7294,1593,127,1593,1173500.0,128300,148,4310,5903,93200,0.0
635,4742,10935,0,2851,10812,9262,8143,1184,167,1184,620600.0,136000,84,3558,4742,207700,1.0
635,32150,81805,29,21308,80979,66668,37904,9118,751,9118,5432600.0,112400,311,23032,32150,127100,1.0
700,60238,156182,96,44255,154701,124881,68445,18497,1596,18497,12350900.0,139900,1081,41741,60238,340100,1.0
679,37782,97038,112,25412,96786,78236,43498,12327,1180,12327,7908200.0,110500,807,25455,37782,216000,1.0
871,40571,103374,21,28846,95058,82527,46453,14902,1330,14902,12656700.0,156500,1138,25669,40571,149000,0.0
659,21431,54032,139,14742,53260,42984,24886,8757,718,8757,5389100.0,84000,332,12674,21431,93800,1.0
776,20945,58503,0,15478,55754,47759,23784,5578,279,5578,3936700.0,146100,208,15367,20945,95200,0.0
836,44657,128753,98,33680,122560,97356,50542,15582,1416,15582,13060200.0,144700,908,29075,44657,84400,0.0
792,17373,52571,203,13534,48448,39042,20426,5736,724,5736,4712100.0,137700,642,11637,17373,81300,0.0
818,47804,112156,101,30428,111062,92888,56398,13249,753,13249,11386600.0,193200,890,34555,47804,117800,0.0
839,1835,5507,19,1292,4853,4502,3311,435,216,435,341700.0,81000,118,1400,1835,74500,0.0
829,63447,169798,312,48610,168622,134480,71720,17757,1749,17757,14357800.0,173600,1677,45690,63447,84500,0.0
1032,395503,1034290,16077,327482,1028876,808915,427292,171286,12404,171286,182834700.0,203900,4809,224217,395503,104400,0.0
694,8819,20426,0,5111,19632,17032,11654,2713,156,2713,1552000.0,81900,144,6106,8819,218900,1.0
761,68805,176484,893,53663,175431,142047,77843,32848,3114,32848,26691900.0,138700,1300,35957,68805,99400,0.0
742,51798,138940,142,36359,136570,111135,61046,16524,1538,16524,11205200.0,130400,1172,35274,51798,120900,0.0
652,17029,44420,0,10994,43979,35064,20118,7049,258,7049,4206100.0,95500,294,9980,17029,164200,1.0
694,11206,27463,31,5869,27175,23188,17961,2241,603,2241,1307900.0,145500,442,8965,11206,195000,1.0
947,9766,25247,34,7598,24904,20251,15326,1711,666,1711,1586000.0,244500,270,8055,9766,87400,0.0
956,73709,222095,429,60362,221079,167613,78150,14370,496,14370,13629100.0,215200,753,59339,73709,133600,0.0
611,27765,68525,0,17381,67722,55762,33412,7074,616,7074,3956900.0,123700,462,20691,27765,130300,1.0
771,145102,368362,1555,106785,365252,291567,161856,54477,6396,54477,42755500.0,151400,2388,90625,145102,49000,0.0
734,36878,94125,122,26379,92801,75501,42765,12806,889,12806,8677500.0,123100,726,24072,36878,63700,0.0
620,13744,37159,0,9226,35923,30563,16372,3362,390,3362,1891900.0,131800,218,10382,13744,97900,0.0
630,14394,34130,21,8978,33803,27584,17830,4481,604,4481,2261900.0,89500,132,9913,14394,116500,1.0
1056,15264,35412,0,11131,35239,29239,34290,4666,3408,4666,4648400.0,285000,543,10598,15264,89500,0.0
864,30000,68699,126,19957,67074,57619,49580,8199,1245,8199,6880600.0,197700,944,21801,30000,111600,0.0
604,8157,20190,0,4709,19271,16825,11916,2284,80,2284,1153400.0,93900,167,5873,8157,83700,0.0
735,32068,81379,39,22575,80308,64297,35879,12677,583,12677,9111500.0,119200,392,19391,32068,106200,0.0
644,7988,19913,49,4852,18658,16669,9853,2106,121,2106,977300.0,78900,179,5882,7988,159100,1.0
798,4439,11601,0,3207,11518,9443,5305,870,57,870,523500.0,142500,163,3569,4439,134500,0.0
610,3303,8607,0,1930,8493,7019,6001,601,172,601,295400.0,124800,104,2702,3303,74100,0.0
637,9624,23227,0,6135,23075,19001,11610,2994,364,2994,1648300.0,83100,105,6630,9624,65900,0.0
644,8346,21347,0,5434,21114,17929,10860,2117,52,2117,1159700.0,172200,313,6229,8346,122300,0.0
716,5395,12803,15,3389,12134,11016,7687,1355,145,1355,789600.0,150600,156,4040,5395,66700,0.0
824,5882,13506,0,3600,13354,11178,7134,1602,140,1602,1201700.0,165500,169,4280,5882,121500,0.0
825,8913,20434,52,5440,20148,17506,11603,2399,117,2399,2123700.0,205500,315,6514,8913,86200,0.0
655,55679,142827,215,39462,141584,113592,61940,15856,843,15856,9920200.0,119500,746,39823,55679,89500,0.0
635,37162,91566,32,24640,90460,74797,43879,11735,1382,11735,6858600.0,109600,911,25427,37162,118900,1.0
640,19273,46124,0,12804,45675,38004,22113,4320,318,4320,2400400.0,123900,337,14953,19273,63200,0.0
619,5223,12331,0,3102,12141,10145,6471,2059,125,2059,1001500.0,86000,142,3164,5223,105400,1.0
1122,3796,10336,0,2881,10218,8153,4197,754,68,754,703700.0,222500,0,3042,3796,80000,0.0
692,5049,10753,0,3021,10716,8959,7301,1125,274,1125,602700.0,154600,63,3924,5049,82700,0.0
887,124500,332766,911,95082,300902,258172,145090,60967,7140,60967,52733800.0,131200,5095,63533,124500,103300,0.0
768,80682,214049,269,58996,212011,170582,91011,27952,2687,27952,20966500.0,130700,1129,52730,80682,133800,0.0
817,200998,517197,2223,152856,513206,414413,225009,82586,9383,82586,68313600.0,160200,2676,118412,200998,95500,0.0
717,16218,41725,87,10903,41452,35276,26847,5653,820,5653,3717700.0,177200,238,10565,16218,70300,0.0
838,38185,94191,18,24566,91293,76305,46093,9783,1290,9783,9319000.0,207300,1275,28402,38185,80100,0.0
859,14629,39546,72,10449,38101,31658,17027,5781,622,5781,4808600.0,158900,447,8848,14629,87900,0.0
614,46163,134187,47,29544,132407,103886,53027,16304,1086,16304,8651600.0,72100,654,29859,46163,140000,1.0
681,23859,60875,51,16807,59526,49252,27495,6566,438,6566,4085400.0,133000,444,17293,23859,69000,0.0
613,5464,14208,0,3567,14026,11377,8913,1543,283,1543,801400.0,122300,29,3921,5464,69600,0.0
1043,381971,1023811,5593,321197,1015242,798455,411632,137179,12675,137179,149023300.0,250700,4821,244792,381971,192200,0.0
599,7493,17605,0,4609,17427,14676,11170,1997,177,1997,1015600.0,139800,401,5496,7493,109700,0.0
687,9647,25531,0,6514,23748,21045,11584,3380,231,3380,1939600.0,83700,182,6267,9647,129600,1.0
783,28148,68364,198,19253,67647,55896,30814,6696,294,6696,4951000.0,251600,432,21452,28148,321000,1.0
613,17970,45069,0,11612,44180,36978,21196,5166,360,5166,2778500.0,110400,195,12804,17970,146000,1.0
763,24287,63866,65,17517,62896,51108,27642,6543,285,6543,4839900.0,140300,361,17744,24287,135100,0.0
827,65401,186308,98,50196,184634,142715,72140,18524,1226,18524,15439100.0,150700,913,46877,65401,98000,0.0
621,4148,9776,0,2659,9686,8172,4948,1139,85,1139,516800.0,92700,31,3009,4148,163800,1.0
726,15513,34160,49,8992,33954,28483,25515,4073,244,4073,2669200.0,162000,502,11440,15513,90300,0.0
649,15772,39240,35,10925,38813,31741,18371,4411,210,4411,2653500.0,118500,358,11361,15772,67100,0.0
883,53104,122586,208,32142,121634,104379,84702,12121,2340,12121,10146600.0,194700,1501,40983,53104,75500,0.0
680,14125,33291,44,8304,32816,28443,19493,3399,138,3399,2106300.0,202100,319,10726,14125,121800,0.0
641,11995,26833,4,7766,26594,22529,17578,3112,280,3112,1492900.0,150300,300,8883,11995,91200,0.0
691,18978,47316,37,11497,46957,38670,25773,5539,736,5539,3334800.0,123600,747,13439,18978,130200,1.0
607,22462,56589,79,13931,53778,45581,26210,6541,467,6541,3425000.0,85200,509,15921,22462,92900,1.0
690,23263,57934,44,16092,56794,46425,27517,9271,973,9271,6040700.0,93500,467,13992,23263,85200,0.0
698,31250,80504,63,22713,79907,65096,34639,7354,499,7354,5273500.0,158700,353,23896,31250,201500,1.0
568,10855,27445,9,6944,26500,21852,16203,3258,373,3258,1601100.0,105900,499,7597,10855,237800,1.0
987,63093,192685,93,50865,153922,149544,77453,29958,4531,29958,28540100.0,154400,1410,33135,63093,126700,0.0
1026,52160,141812,4712,41593,141148,116954,56941,19910,1544,19910,21358900.0,283000,826,32250,52160,175500,0.0
617,18371,45447,14,11198,44066,36104,21234,6346,294,6346,3544900.0,80000,373,12025,18371,96900,1.0
614,26497,66523,42,16547,65620,54174,34181,7548,949,7548,4383900.0,109000,625,18949,26497,75800,0.0
647,23431,63664,28,16426,63040,49632,27513,7129,440,7129,3944600.0,87700,243,16302,23431,80600,0.0
626,29256,72315,168,18925,71514,58544,33950,7893,1293,7893,4603100.0,120900,660,21363,29256,269900,1.0
600,15521,37825,0,10180,37534,30627,17412,3739,564,3739,2041100.0,127300,274,11782,15521,66500,0.0
723,6725,17535,26,4229,15412,15257,14110,1549,672,1549,944500.0,138800,323,5176,6725,139900,0.0
897,105407,252268,749,74306,248611,209194,119412,38287,1918,38287,34137400.0,209800,1765,67120,105407,185700,0.0
635,34568,88898,57,22783,86617,73656,40989,9835,662,9835,5501300.0,115400,830,24733,34568,83200,0.0
856,70598,196716,651,56261,195309,151481,76784,20589,1853,20589,17659400.0,180300,1215,50009,70598,215500,1.0
557,9160,22833,14,6137,21970,18983,10748,2162,199,2162,1082600.0,104700,375,6998,9160,97800,0.0
693,15895,41766,70,10864,41422,33984,18477,3572,325,3572,2223500.0,170000,460,12323,15895,183200,1.0
687,64727,164118,276,46422,162246,131347,73827,18395,1354,18395,12463300.0,134800,1491,46332,64727,96900,0.0
640,21669,59350,9,14757,58894,46227,25834,6570,568,6570,3586000.0,88800,478,15099,21669,79800,0.0
966,120936,300865,5461,97737,295299,241790,130691,56268,4204,56268,55575100.0,195900,1297,64668,120936,105300,0.0
709,8880,24262,20,5976,22145,20127,10645,2913,288,2913,1838700.0,86800,153,5967,8880,224800,1.0
723,21691,59805,89,16073,58597,46478,24405,7091,849,7091,4913300.0,138400,460,14600,21691,103900,0.0
938,91673,219866,1120,66821,217425,182320,107369,39062,3073,39062,37163100.0,225600,1773,52611,91673,185600,0.0
828,21053,57630,42,14523,56059,46303,28115,4395,537,4395,3292200.0,167200,633,16658,21053,138600,0.0
743,47587,124496,195,33961,120019,98155,53902,18623,1320,18623,12965500.0,117000,868,28964,47587,88800,0.0
704,950,2253,0,698,2251,1683,1398,243,51,243,164700.0,115300,32,707,950,122300,1.0
718,3213,9986,28,2327,9901,7679,4903,975,290,975,605400.0,169800,62,2238,3213,64000,0.0
575,3349,8050,5,2553,7861,6477,3834,886,152,886,499100.0,127200,45,2463,3349,197200,1.0
922,12895,32916,26,10779,32554,24995,17790,4920,1909,4920,5080100.0,238900,295,7975,12895,83300,0.0
856,401,983,10,273,983,785,535,105,15,105,64000.0,185300,5,296,401,166100,0.0
608,2192,5041,0,1617,4902,4076,2670,655,96,655,331900.0,110400,36,1537,2192,161400,1.0
504,1053,2457,6,722,2453,2008,1675,253,24,253,101100.0,104400,25,800,1053,165800,1.0
548,1787,3817,0,1245,3719,3111,2341,322,42,322,153400.0,95500,63,1465,1787,104700,1.0
986,27449,69628,120,23110,65462,54933,32248,11078,1988,11078,11388400.0,211900,688,16371,27449,88500,0.0
525,1110,2387,0,645,2338,1983,1725,168,33,168,90600.0,79800,16,942,1110,85300,1.0
522,2663,5951,0,1886,5869,4715,3155,432,37,432,194500.0,116700,41,2231,2663,114000,0.0
563,3218,7050,0,2344,6862,5731,3859,738,86,738,368200.0,85500,110,2480,3218,200400,1.0
545,916,1915,3,644,1915,1574,1238,141,27,141,61200.0,72000,15,775,916,146500,1.0
444,2292,6875,13,1611,6861,4738,3032,853,80,853,296900.0,68900,33,1439,2292,82600,1.0
583,1078,2601,10,715,2439,2078,1450,191,33,191,93000.0,108200,30,887,1078,57100,0.0
567,1811,4106,0,1225,4034,3282,2240,413,33,413,179300.0,91100,70,1398,1811,151700,1.0
839,13246,30059,0,10583,29494,24069,14324,3643,122,3643,2945300.0,187600,167,9603,13246,153100,0.0
770,73039,170620,841,61702,169233,136469,77895,34890,2465,34890,28762200.0,198100,605,38149,73039,112500,0.0
887,1601,4349,4,1159,4295,3499,2523,354,56,354,272300.0,168800,44,1247,1601,76500,0.0
420,1565,3389,1,891,3334,2802,2178,243,48,243,74900.0,92200,44,1322,1565,79400,0.0
530,1325,2680,3,874,2571,2264,1845,286,68,286,137100.0,72300,32,1039,1325,117000,1.0
488,1492,2971,1,988,2891,2493,1885,366,48,366,176400.0,78700,33,1126,1492,77300,0.0
560,6829,16333,0,5301,16177,13252,7718,1980,359,1980,1050000.0,116000,57,4849,6829,157100,1.0
356,4740,14657,3,3105,14539,10170,5565,1469,137,1469,582600.0,73700,28,3271,4740,82000,1.0
613,4838,10920,9,3550,10736,8727,5598,1226,151,1226,590400.0,83700,61,3612,4838,107900,1.0
491,1052,2368,7,765,2316,1973,1395,283,10,283,160600.0,144900,37,769,1052,63300,0.0
693,3096,6651,0,2289,6483,5454,4426,751,55,751,475300.0,140500,114,2345,3096,68200,0.0
675,5113,10971,56,3707,10775,9072,5826,1689,73,1689,1030700.0,117200,55,3424,5113,112500,0.0
473,1048,2321,0,707,2248,1862,1316,306,45,306,152300.0,74200,28,742,1048,135200,1.0
796,29716,70130,275,24254,67954,57191,32029,15124,1187,15124,12549100.0,181600,327,14592,29716,163700,0.0
1037,3651,11679,39,2926,11594,8634,5320,1520,332,1520,1610300.0,213600,62,2131,3651,58900,0.0
692,3649,8637,19,2799,8514,6915,4717,649,167,649,408300.0,166200,62,3000,3649,168700,0.0
595,4313,9607,21,3065,9419,7858,6065,810,77,810,430800.0,159300,45,3503,4313,116900,0.0
644,1995,4272,0,1334,4093,3493,2313,561,20,561,318300.0,110400,0,1434,1995,74300,0.0
581,2333,5411,0,1692,5259,4385,2696,705,73,705,371200.0,120600,29,1628,2333,123400,0.0
661,1011,2543,6,687,2474,1958,1301,209,48,209,116100.0,125900,48,802,1011,100200,0.0
486,1114,4420,8,808,4381,2908,1340,622,20,622,284000.0,76300,6,492,1114,141700,1.0
607,1432,3226,0,1088,3165,2555,1739,370,67,370,223400.0,149600,15,1062,1432,164900,1.0
822,38901,92372,118,31321,90369,73158,41103,12116,1049,12116,10607500.0,237000,295,26785,38901,50900,0.0
638,863,1892,0,620,1836,1491,1042,283,27,283,122700.0,119900,21,580,863,70900,0.0
610,879,1932,0,561,1856,1638,1184,130,23,130,69500.0,79000,3,749,879,74300,0.0
573,788,1822,0,544,1817,1464,1004,102,35,102,32700.0,171800,17,686,788,60100,0.0
520,1033,2258,0,605,2229,1786,1380,220,58,220,86700.0,73000,0,813,1033,73000,0.0
673,9199,21058,72,6971,20157,17237,10172,3220,220,3220,2088600.0,130900,48,5979,9199,68200,0.0
546,4931,11574,58,3631,11098,9298,5843,1941,259,1941,1226500.0,130400,92,2990,4931,152200,1.0
823,1053,2378,0,649,2295,1968,1531,235,54,235,175400.0,150800,20,818,1053,151800,0.0
536,1502,3318,0,1079,3243,2689,1827,386,30,386,190400.0,125600,5,1116,1502,159300,1.0
405,1039,2276,2,745,2179,1881,1438,296,9,296,88800.0,91800,10,743,1039,283000,1.0
604,1819,3883,7,1325,3844,3197,2101,466,45,466,267900.0,96400,31,1353,1819,173100,1.0
330,684,1403,0,424,1403,1210,855,147,6,147,48300.0,84900,0,537,684,181200,1.0
663,309,674,4,199,674,544,448,63,9,63,29400.0,89300,6,246,309,237400,1.0
926,11962,30316,79,9649,29932,23495,14090,4012,870,4012,4237400.0,228200,233,7950,11962,123000,0.0
514,1988,4089,0,1380,3998,3372,2535,396,90,396,162800.0,84200,81,1592,1988,117600,1.0
646,11520,30203,10,7643,29822,24056,13892,2832,335,2832,1618600.0,103200,534,8688,11520,160200,1.0
650,22876,58497,29,16683,57967,45635,25259,6880,593,6880,4335800.0,118800,280,15996,22876,130300,1.0
649,98035,231857,894,67105,227056,190128,111499,30721,2414,30721,20099000.0,99300,3393,67314,98035,199300,1.0
754,22509,65563,161,15340,64883,57033,26597,9726,1136,9726,7400500.0,116500,399,12783,22509,137200,1.0
571,10829,27926,45,6432,27656,21863,12924,3424,211,3424,1730600.0,98000,272,7405,10829,242300,1.0
585,30204,76871,76,18147,74052,62005,34332,9734,608,9734,5257500.0,93000,393,20470,30204,152500,1.0
846,67192,176362,368,52271,175201,140181,71310,13483,880,13483,11850000.0,185800,1019,53709,67192,152600,0.0
584,9285,23234,32,5835,23031,18772,11155,2034,113,2034,1085400.0,87400,250,7251,9285,174200,1.0
876,19038,54688,190,15436,51476,42404,20423,4167,243,4167,3618600.0,186000,282,14871,19038,159600,0.0
720,15274,39005,0,11249,38525,31287,16774,4174,240,4174,2879200.0,126700,375,11100,15274,184100,1.0
665,11033,28291,41,7094,27954,22412,12748,3448,243,3448,2137900.0,100100,174,7585,11033,213600,1.0
633,7589,18951,14,5285,18845,14973,8750,1754,183,1754,1123800.0,92500,419,5835,7589,148400,1.0
866,64702,164825,286,48550,160786,134721,69576,21441,1332,21441,18984600.0,163500,738,43261,64702,154000,0.0
749,338267,808703,14391,255742,800780,641643,378156,143031,11380,143031,114367500.0,145800,4029,195236,338267,92900,0.0
903,496337,1253507,14822,399267,1245449,988128,546040,230291,18338,230291,213644800.0,158400,5414,266046,496337,145600,0.0
682,23731,61057,73,15274,60474,49178,27501,6695,697,6695,3908400.0,101500,754,17036,23731,162400,1.0
712,24699,65483,181,16836,59921,53298,27894,7815,354,7815,5383900.0,93700,348,16884,24699,124600,1.0
550,6116,14773,23,3921,14589,11966,7926,1338,73,1338,630000.0,90500,83,4778,6116,166100,1.0
725,36548,92531,91,26173,91574,73739,40180,10711,589,10711,7532400.0,117100,404,25837,36548,333600,1.0
700,43353,115915,118,32065,114790,90687,46369,11724,740,11724,7744100.0,140100,552,31629,43353,599500,1.0
638,9157,22190,14,6702,21928,17573,9934,2540,136,2540,1534400.0,110600,146,6617,9157,546000,1.0
668,17333,43799,22,11947,43252,34859,19917,4453,303,4453,2620700.0,118600,485,12880,17333,-666666666,1.0
839,136416,375702,992,105237,372296,295554,150523,43099,3697,43099,37106000.0,162300,1778,93317,136416,144800,0.0
716,31577,75369,315,22308,74420,61728,37827,9727,787,9727,6789300.0,132400,877,21850,31577,124500,0.0
625,6192,15397,5,4235,15136,12609,8110,1295,111,1295,719700.0,88600,201,4897,6192,100900,1.0
712,23229,60945,91,16627,60352,48530,25648,6658,267,6658,4729300.0,138900,252,16571,23229,84700,0.0
792,64434,170678,246,48394,169335,135314,70449,17773,1614,17773,14177300.0,157800,1414,46661,64434,117600,0.0
638,47987,121533,555,32856,114868,97973,54274,15489,980,15489,10044800.0,103700,643,32498,47987,102900,0.0
585,5053,13142,18,3278,13065,10541,6261,1342,64,1342,618900.0,85700,166,3711,5053,99600,1.0
682,10917,27825,2,7604,27540,22765,13619,2178,142,2178,1250400.0,116700,302,8739,10917,87700,0.0
721,32049,75508,77,24100,74673,60482,33881,9848,323,9848,7338900.0,132600,311,22201,32049,73100,0.0
800,76143,202166,519,58601,200864,159497,82400,19603,1383,19603,15611500.0,160600,1172,56540,76143,109400,0.0
836,55549,151526,237,42030,148789,119267,60202,15761,1054,15761,13287500.0,168500,669,39788,55549,82200,0.0
703,15309,38311,72,11296,38007,30549,16775,3646,263,3646,2320100.0,112700,318,11663,15309,103400,0.0
668,16731,43031,67,10971,42611,33872,19339,4988,253,4988,3020200.0,107800,412,11743,16731,126100,1.0
669,11094,27463,41,8354,27056,21751,12043,2397,95,2397,1619100.0,116200,174,8697,11094,148100,1.0
622,27571,67349,114,17826,66602,55721,32601,8534,918,8534,4882200.0,88700,1162,19037,27571,169800,1.0
824,62208,162080,520,46461,161013,134981,68623,19498,1271,19498,16619300.0,152000,625,42710,62208,76500,0.0
677,13159,34037,115,10186,33778,26330,13857,2597,76,2597,1648600.0,147200,117,10562,13159,99400,0.0
607,26910,68889,108,18471,65032,57338,32287,6496,949,6496,3423200.0,94800,1134,20414,26910,94400,0.0
719,16309,41869,68,11521,41542,32994,18159,5692,274,5692,3873400.0,123700,314,10617,16309,224800,1.0
709,11729,28659,23,8046,28227,22568,12714,4445,184,4445,2965800.0,108900,142,7284,11729,111800,0.0
635,13576,35983,85,9523,35728,28361,15257,3572,157,3572,2005200.0,102500,200,10004,13576,106500,0.0
779,19465,57075,34,14585,52578,46194,21310,5091,636,5091,3775500.0,152000,193,14374,19465,86700,0.0
717,18627,45323,32,13395,44989,36053,23343,4873,245,4873,3105500.0,127200,594,13754,18627,77400,0.0
776,14916,43732,35,11185,38792,35703,16041,4279,113,4279,3078100.0,156700,259,10637,14916,71500,0.0
783,223021,541318,4449,164246,536137,439353,245731,76618,5874,76618,61166000.0,137000,3211,146403,223021,118800,0.0
665,34348,85933,94,24043,85105,68677,37947,11241,769,11241,7174300.0,112500,616,23107,34348,83100,0.0
666,23721,59559,203,17288,58686,47491,26332,6776,776,6776,4350700.0,111900,356,16945,23721,259900,1.0
706,18665,48902,48,14451,48565,37889,20399,5456,301,5456,3971200.0,137800,242,13209,18665,83700,0.0
678,11503,28262,23,8352,27985,22437,12726,2899,173,2899,1773500.0,99000,547,8604,11503,85000,0.0
639,25378,60871,7,17317,60177,50349,28251,6634,566,6634,3914300.0,119400,293,18744,25378,78100,0.0
665,15263,37061,69,11121,35876,29551,16630,3597,166,3597,2351500.0,94200,155,11666,15263,126000,1.0
688,18342,45778,18,13727,45256,35900,19810,4439,171,4439,3155300.0,143100,234,13903,18342,86700,0.0
643,41582,104584,142,28657,101017,85281,46824,11136,828,11136,6547700.0,104300,1023,30446,41582,191300,1.0
645,20803,51919,126,14849,51295,40829,22813,5730,404,5730,3507800.0,113200,287,15073,20803,144200,1.0
699,17495,40769,137,12244,40364,34008,28300,3809,330,3809,2698300.0,145400,568,13686,17495,299000,1.0
683,16404,42296,21,12483,41902,33280,17482,3733,159,3733,2539300.0,134700,158,12671,16404,138100,0.0
640,11430,31576,22,8057,31383,25170,13184,3399,291,3399,1930300.0,95400,299,8031,11430,137400,1.0
673,12964,32624,8,8712,32289,25763,14741,4081,167,4081,2411400.0,93900,374,8883,12964,97000,0.0
699,178971,433404,3065,129082,428267,344179,202852,71650,6141,71650,49778500.0,109000,3156,107321,178971,237200,1.0
646,12781,34935,161,9425,34670,27598,14234,2259,102,2259,1366500.0,139400,176,10522,12781,143100,0.0
634,5012,14498,0,2886,11973,12103,6126,788,74,788,430700.0,91300,10,4224,5012,104800,1.0
706,16126,41328,30,11535,40991,33117,17899,3818,309,3818,2486400.0,116900,358,12308,16126,69700,0.0
672,21507,55549,81,15469,54607,44651,24105,5973,682,5973,3781800.0,98600,458,15534,21507,162700,1.0
711,152037,374273,2114,109829,369531,302683,166207,48058,3307,48058,33406000.0,127100,2093,103979,152037,91300,0.0
663,40319,104157,296,29403,101696,82706,45005,13674,844,13674,9394800.0,110900,803,26645,40319,219600,1.0
594,14367,36602,34,9650,36206,28838,16450,3555,329,3555,1940000.0,95500,239,10812,14367,166700,1.0
637,17833,42231,63,12072,41665,33998,20084,5477,416,5477,3356800.0,85600,246,12356,17833,85400,0.0
1001,67701,193024,137,55654,192150,145808,70753,12702,1042,12702,13335800.0,279800,725,54999,67701,78800,0.0
813,35121,93895,156,26922,93218,74604,36921,4992,158,4992,3976300.0,228000,596,30129,35121,117000,0.0
626,16065,39414,44,10647,38938,31576,19284,4560,615,4560,2682600.0,103100,409,11505,16065,124700,1.0
585,11268,28547,81,7831,27897,22978,13391,2856,139,2856,1538800.0,118400,277,8412,11268,80500,0.0
865,95238,229701,1003,72170,227606,188043,102362,24142,1808,24142,21161100.0,150100,1461,71096,95238,114300,0.0
646,16142,40723,69,12213,40331,31636,17851,3645,247,3645,2262500.0,137900,339,12497,16142,100700,0.0
721,28526,77125,213,19585,71395,62188,32037,8451,573,8451,5285700.0,114600,433,20075,28526,144600,1.0
706,54836,135520,495,38468,133707,108254,61341,18841,1220,18841,13306200.0,107300,1395,35995,54836,232000,1.0
766,537621,1257401,27248,382521,1242429,1021907,619305,221249,21335,221249,172420800.0,123900,9687,316372,537621,73800,0.0
602,12520,43808,29,9784,42998,31293,13639,2915,152,2915,1450300.0,183800,77,9605,12520,89600,0.0
751,118594,305405,774,86831,298973,244842,129717,33910,2294,33910,26782400.0,140300,1820,84684,118594,104800,0.0
756,40900,104081,150,30706,103188,82775,44293,12385,810,12385,9059300.0,138900,500,28515,40900,99500,0.0
570,5984,14239,84,3676,14095,11602,7504,1302,88,1302,603000.0,97400,107,4682,5984,90000,0.0
754,223495,531987,5445,160017,523788,426873,254840,86782,6853,86782,65503500.0,112100,4893,136713,223495,81700,0.0
649,86709,203341,366,57819,199734,166161,95777,25524,2014,25524,15740200.0,101600,2457,61185,86709,75300,0.0
998,80704,223868,374,65290,216797,173155,84853,18111,1076,18111,17820900.0,200100,570,62593,80704,106400,0.0
767,50187,129504,197,39447,128164,106256,53786,17195,1048,17195,13895900.0,154700,657,32992,50187,209100,1.0
707,20504,53299,62,14981,52713,42565,22235,5614,298,5614,3776500.0,122000,265,14890,20504,129900,1.0
648,38381,98622,254,25470,95570,79229,46118,11399,1004,11399,7034100.0,106300,835,26982,38381,101500,0.0
549,7796,22136,7,4890,22006,16885,9305,2358,192,2358,1019900.0,81200,242,5438,7796,117000,1.0
600,9240,25246,30,5852,24787,19567,11694,2765,288,2765,1356700.0,71200,211,6475,9240,130300,1.0
677,17252,44293,89,11887,43669,35105,20682,4932,398,4932,3107000.0,104000,406,12320,17252,63600,0.0
448,990,2221,0,676,2197,1747,1578,268,52,268,84000.0,57400,21,722,990,85900,1.0
517,3819,9680,3,2587,8178,7649,4983,912,94,912,410400.0,83800,53,2907,3819,85400,0.0
717,18278,48407,109,12967,47753,37450,21583,5629,938,5629,3898400.0,109000,448,12649,18278,80100,0.0
609,2240,5666,16,1409,5598,4423,2812,630,95,630,298000.0,87800,59,1610,2240,122500,1.0
649,1883,4458,0,1306,4375,3493,2473,455,41,455,200000.0,76400,99,1428,1883,152600,1.0
517,2152,6018,0,1410,4986,4992,2727,592,28,592,248400.0,65800,47,1560,2152,109700,1.0
714,5691,15510,0,4173,15350,11728,6493,1130,97,1130,736000.0,136200,25,4561,5691,101600,0.0
704,13838,37919,0,10203,37598,29158,15089,3010,212,3010,1981200.0,166400,212,10828,13838,97600,0.0
576,8349,19874,42,4751,19577,16251,13636,1909,99,1909,890100.0,95300,348,6440,8349,87000,0.0
648,6241,16226,49,4079,15974,12827,10207,1526,126,1526,822700.0,86600,176,4715,6241,167900,1.0
679,5275,13797,0,3753,13411,10926,6827,1701,166,1701,949800.0,107100,206,3574,5275,94900,0.0
716,4598,11421,28,3449,11325,9014,5330,1222,178,1222,783400.0,94800,148,3376,4598,137900,1.0
642,4064,10448,7,2744,10254,8329,4850,986,47,986,561000.0,81600,126,3078,4064,89700,1.0
661,12020,31725,42,8033,31274,24772,14096,3775,477,3775,2238600.0,84300,314,8245,12020,85500,0.0
817,34109,90098,25,26267,89050,70828,37093,7456,535,7456,5675700.0,150900,688,26653,34109,129200,0.0
655,15412,41364,50,9988,40984,32897,19061,4445,660,4445,2568900.0,92500,513,10967,15412,102000,1.0
835,28309,76830,18,21631,76551,59756,31439,5885,349,5885,4566400.0,150400,607,22424,28309,179600,1.0
677,1978,5877,1,1333,4830,4843,2735,475,63,475,231000.0,74500,66,1503,1978,151900,1.0
646,3413,9132,0,2624,8512,7563,4435,1125,228,1125,662400.0,93100,62,2288,3413,89500,0.0
568,10273,29437,48,6926,28419,22860,13244,3041,296,3041,1362700.0,81900,328,7232,10273,116700,1.0
876,103028,274024,350,83555,268406,219767,112483,36578,4104,36578,33569700.0,155500,2123,66450,103028,106300,0.0
658,26097,69471,132,17347,66591,54180,30948,8733,793,8733,5477500.0,97700,714,17364,26097,113500,1.0
547,3987,12160,15,2580,11177,9635,5314,1083,79,1083,450500.0,79100,72,2904,3987,79600,0.0
578,5284,13899,4,3323,12255,11123,6393,1415,96,1415,610800.0,98400,120,3869,5284,138700,1.0
703,16911,45068,57,11439,44611,35715,20129,6253,641,6253,4105900.0,98900,254,10658,16911,186000,1.0
644,1727,4904,2,1191,4801,3732,2440,464,38,464,167200.0,86700,30,1263,1727,104000,1.0
652,1348,3843,0,895,3824,2886,1895,262,28,262,132700.0,76300,19,1086,1348,112100,1.0
653,17890,45173,34,12704,44496,35160,21522,5562,553,5562,3305000.0,84100,898,12328,17890,115700,1.0
748,15651,45326,62,11768,44956,35762,17462,3212,405,3212,2203700.0,153100,289,12439,15651,121500,0.0
677,5413,14563,0,3538,13817,11695,6743,1433,123,1433,828700.0,96100,103,3980,5413,165400,1.0
818,250071,637123,2073,193873,632310,491744,278844,102396,10632,102396,85222600.0,145800,4973,147675,250071,88700,0.0
687,20688,51867,19,14320,51477,40925,23652,6234,449,6234,4418200.0,112600,437,14454,20688,108800,0.0
934,43878,132922,122,35422,131086,101635,47630,10421,918,10421,9568800.0,155400,995,33457,43878,98700,0.0
538,1185,2758,0,805,2655,2180,1532,327,11,327,128800.0,49700,0,858,1185,141000,1.0
591,4849,12746,0,2987,12686,10030,6113,1230,232,1230,604200.0,87500,140,3619,4849,115400,1.0
544,4019,10621,17,2516,10424,8549,4997,1282,59,1282,572100.0,81100,104,2737,4019,77400,0.0
630,14852,39121,4,9627,38447,30813,17862,4358,369,4358,2289700.0,80300,325,10494,14852,123800,1.0
707,18314,47350,79,12300,45964,37813,21649,4195,284,4195,2465100.0,110100,415,14119,18314,124700,1.0
707,6989,21409,8,5756,21285,16194,8229,2460,289,2460,1553300.0,109300,34,4529,6989,165700,1.0
513,2392,6270,0,1412,6126,4959,3395,671,59,671,256600.0,59700,112,1721,2392,103900,1.0
511,4550,11132,0,2710,11013,8908,6153,1193,114,1193,455100.0,73400,102,3357,4550,158200,1.0
806,23798,62421,58,18078,60342,47688,26769,8224,1122,8224,6424300.0,104000,443,15574,23798,154300,1.0
631,10473,27751,23,6691,27502,21569,12856,3390,184,3390,1735500.0,93400,97,7083,10473,110300,1.0
576,4256,11039,3,2677,10911,8639,5168,1225,82,1225,528200.0,79500,149,3031,4256,92200,1.0
689,17828,44673,20,11796,42801,35850,23057,4859,559,4859,2893200.0,98400,519,12969,17828,146000,1.0
659,14512,38289,45,10619,37829,30079,16785,5221,647,5221,3166400.0,120300,244,9291,14512,134500,1.0
563,1350,3734,2,885,3715,2849,1910,382,15,382,81600.0,106100,5,968,1350,126400,1.0
768,7366,21140,0,5600,20142,16403,8965,2093,401,2093,1569500.0,123000,46,5273,7366,71300,0.0
621,16360,48404,127,10669,47972,38602,21983,5486,751,5486,3250300.0,111300,716,10874,16360,99600,0.0
655,16571,41878,18,9855,41497,34192,25290,3973,436,3973,2188400.0,110000,752,12598,16571,143500,1.0
646,1625,4102,0,1052,4060,3239,2276,436,81,436,187600.0,83700,83,1189,1625,127700,1.0
682,19743,54351,16,14249,53846,42643,22701,4473,381,4473,2509500.0,117200,327,15270,19743,97200,0.0
765,30404,80634,431,22678,79490,66524,35603,15354,1856,15354,12370800.0,147400,766,15050,30404,158300,1.0
674,25925,71614,74,18161,69464,56218,29788,8085,468,8085,5129600.0,108400,470,17840,25925,111100,0.0
755,26398,70899,83,18551,70086,55867,30396,6843,509,6843,4433000.0,112100,496,19555,26398,178100,1.0
598,3012,7591,0,2053,7237,5946,4014,695,146,695,332100.0,54100,54,2317,3012,130100,1.0
661,4484,11550,3,3180,11292,8903,5451,1215,51,1215,550000.0,80200,100,3269,4484,149800,1.0
619,2265,6000,0,1522,5858,4785,3004,491,27,491,246000.0,77600,357,1774,2265,121000,1.0
601,3839,9127,0,2582,8933,7190,5169,1181,86,1181,496900.0,62500,51,2658,3839,85500,1.0
610,18354,49860,22,11727,48731,39244,21906,4922,451,4922,2554300.0,87200,337,13432,18354,106200,1.0
582,12980,33026,87,8267,32623,25623,15658,3930,557,3930,1851100.0,78000,481,9050,12980,148800,1.0
662,3030,7730,0,2142,7636,5996,3671,672,45,672,349200.0,94000,58,2358,3030,92400,0.0
691,15730,40929,11,10789,40487,32393,19455,4177,301,4177,2399200.0,106700,278,11553,15730,162700,1.0
819,296818,774203,1842,227849,761515,595344,332716,121920,12919,121920,102036500.0,142700,4301,174898,296818,249400,1.0
697,10458,29169,34,8077,28686,22626,12484,4254,685,4254,2886100.0,127600,41,6204,10458,118100,0.0
667,2103,5445,17,1531,5361,4179,2672,461,49,461,220400.0,106500,49,1642,2103,179200,1.0
694,3104,9843,16,2165,9758,7700,4566,670,307,670,374900.0,94600,257,2434,3104,143800,1.0
740,7573,22971,15,5824,21284,17658,9971,2602,382,2602,1522800.0,117100,276,4971,7573,104300,0.0
565,4258,13519,51,2587,11894,10964,6246,1073,202,1073,422600.0,69400,147,3185,4258,222500,1.0
548,5962,14979,46,3419,14804,11765,7577,1871,213,1871,904700.0,88800,143,4091,5962,97200,1.0
698,9958,25574,5,7275,24107,19453,12139,4248,338,4248,2871100.0,97800,263,5710,9958,143500,1.0
807,42957,123066,411,33123,110771,96477,51669,19906,2776,19906,16245600.0,125600,3540,23051,42957,120500,0.0
651,12923,34759,19,8460,34384,27242,15364,2690,303,2690,1439500.0,103400,273,10233,12923,118100,1.0
694,6211,16448,29,4074,16286,12943,7805,1494,137,1494,833700.0,87500,165,4717,6211,122400,1.0
879,116077,330453,2416,86681,323937,256522,124317,46715,2332,46715,43159300.0,205600,1341,69362,116077,82400,0.0
931,86195,212070,619,55741,210868,172986,93704,31963,1311,31963,31509000.0,240900,1178,54232,86195,134200,0.0
772,44828,107576,109,27412,106896,89306,49838,14363,779,14363,11033400.0,174200,811,30465,44828,77600,0.0
643,3176,7209,7,2028,7087,6082,4371,853,63,853,496800.0,155400,157,2323,3176,153700,0.0
818,7628,22707,15,5139,21943,17901,9951,2385,116,2385,1808900.0,178300,150,5243,7628,158200,0.0
870,29128,79666,97,20224,79298,63435,31403,10322,594,10322,9502000.0,224700,434,18806,29128,111400,0.0
1145,153822,399962,5453,116236,398339,322865,163650,46783,1856,46783,55744500.0,341600,1564,107039,153822,157800,0.0
1061,69631,175321,326,48727,174746,142265,85012,24190,1063,24190,26532400.0,298200,1493,45441,69631,160900,0.0
888,46265,121074,101,32314,120409,96368,49688,16616,1002,16616,14599700.0,184900,592,29649,46265,101600,0.0
831,10454,25840,8,6191,25201,21442,18789,3219,276,3219,2630300.0,233500,231,7235,10454,75400,0.0
963,35952,102366,269,25958,100149,81540,38286,11524,504,11524,11843400.0,254000,520,24428,35952,99800,0.0
658,7033,15980,0,4259,15491,13191,8971,2227,178,2227,1437900.0,145600,119,4806,7033,90900,0.0
847,35614,84514,126,20073,83876,70221,38603,11983,671,11983,10149000.0,235600,525,23631,35614,89100,0.0
740,27171,66018,88,17515,65424,53329,33302,9512,976,9512,7156400.0,156900,734,17659,27171,114000,0.0
699,26976,76736,111,20043,72331,59246,30172,10009,693,10009,6882300.0,147900,304,16967,26976,100100,0.0
862,20674,47307,246,11962,46983,40089,31200,7529,483,7529,6296800.0,227700,648,13145,20674,71100,0.0
962,34775,88249,889,25407,87986,75426,37789,14988,1583,14988,15488200.0,288700,185,19787,34775,104700,0.0
877,19213,50207,159,12951,49946,40552,21007,5193,61,5193,4608600.0,223300,616,14020,19213,96200,0.0
821,9330,21717,0,5695,21644,18075,10569,3037,15,3037,2314000.0,187200,118,6293,9330,88800,0.0
765,779,1635,0,485,1634,1417,943,282,14,282,180600.0,144000,18,497,779,92500,0.0
743,10135,25687,26,6997,25272,20530,11600,3638,88,3638,2864900.0,191400,161,6497,10135,82000,0.0
586,3079,7195,0,1955,7090,5875,3870,927,123,927,460800.0,111900,126,2152,3079,159400,1.0
921,148752,363471,4898,103562,361882,302958,160440,61213,3722,61213,58034000.0,232800,1853,87539,148752,80000,0.0
668,10262,30421,19,7038,27073,23601,11806,4309,249,4309,2508100.0,127700,153,5953,10262,150700,1.0
676,3126,6864,0,1905,6763,5785,4158,1003,66,1003,637600.0,217600,65,2123,3126,124400,0.0
1183,212778,572071,18070,173260,568631,450134,223394,83402,3246,83402,101982300.0,331700,2164,129376,212778,94300,0.0
592,677,1415,0,342,1412,1217,984,176,17,176,69100.0,138300,31,501,677,92900,0.0
739,3936,11153,8,2910,11143,8487,4558,1145,43,1145,762800.0,131600,138,2791,3936,87600,0.0
889,15976,38021,141,10935,37244,31477,22174,6220,718,6220,5729600.0,253900,367,9756,15976,94100,0.0
754,26473,62921,190,15453,62058,52667,30870,9212,699,9212,7115000.0,177300,607,17261,26473,100000,0.0
856,10382,22377,0,5199,22226,19361,12847,3373,353,3373,2864300.0,221300,421,7009,10382,78000,0.0
814,805,1910,0,511,1906,1529,1070,290,22,290,192400.0,110900,50,515,805,146400,1.0
983,8543,22938,0,6245,22852,17946,9697,3092,144,3092,2784300.0,339400,103,5451,8543,128000,0.0
647,3522,7807,0,2063,7274,6454,4503,1425,49,1425,805600.0,123100,141,2097,3522,167800,1.0
1094,318173,788459,45721,247635,783195,649097,337821,145281,5628,145281,168022100.0,330900,3101,172892,318173,140200,0.0
746,10291,25810,44,7096,25572,20699,11684,3779,411,3779,2682800.0,172100,137,6512,10291,105500,0.0
1193,35421,83204,798,26054,79839,70162,42291,13448,819,13448,16245500.0,362800,441,21973,35421,131900,0.0
986,69013,164012,970,52039,162788,136354,74158,20365,1129,20365,20103000.0,212600,812,48648,69013,162100,0.0
923,238465,633704,10384,175398,624252,516961,265807,111618,9835,111618,100347500.0,214400,3469,126847,238465,107600,0.0
1021,19521,49028,397,14523,48386,40843,20964,6055,541,6055,6270700.0,341300,264,13466,19521,86400,0.0
1086,49608,126190,597,36932,125258,107009,63450,13251,704,13251,14184300.0,320600,724,36357,49608,102900,0.0
1032,204870,563384,28078,158435,555828,453735,223769,62304,5642,62304,68014300.0,235200,5070,142566,204870,166500,0.0
840,60102,153003,132,44055,151587,122408,64884,17689,660,17689,14431700.0,175800,971,42413,60102,152400,0.0
733,14702,45056,16,10081,39522,38119,17278,4298,395,4298,3199100.0,172200,162,10404,14702,85300,0.0
832,19202,51656,228,12172,48066,44010,32148,3988,291,3988,2611200.0,174600,470,15214,19202,162200,0.0
658,19666,48891,91,13002,48407,40305,24277,4024,456,4024,2328200.0,126800,369,15642,19666,116200,0.0
893,111489,273329,3297,84234,270039,218965,123197,40652,3253,40652,36221200.0,163300,1715,70837,111489,252000,1.0
572,1473,7388,1,618,2901,6849,8233,215,51,215,77600.0,91000,41,1258,1473,141100,1.0
607,29918,75619,27,20278,70780,63531,38390,6622,711,6622,3653700.0,103100,442,23296,29918,102700,0.0
1071,57526,167306,3116,42725,166303,138147,81125,12539,1158,12539,12611200.0,167200,1673,44987,57526,252900,1.0
970,591280,1569657,162951,405632,1555692,1259909,679876,282585,26050,282585,280818400.0,151500,12708,308695,591280,165500,1.0
915,169667,442216,1692,130025,437185,355090,182686,43365,3050,43365,38429800.0,170300,4467,126302,169667,142100,0.0
674,151892,356835,1901,105610,353333,298369,169894,34092,2942,34092,21910000.0,144900,3312,117800,151892,125600,0.0
676,51638,124736,458,35284,123288,101846,56646,15453,908,15453,10205100.0,117300,463,36185,51638,183300,1.0
720,24851,61546,45,16737,60936,49399,30495,6256,682,6256,4319600.0,145600,342,18595,24851,152900,1.0
604,57154,135871,635,37649,132115,112678,65881,14699,1196,14699,8256900.0,88900,1315,42455,57154,158200,1.0
1256,188613,514652,7361,151866,509840,408926,197919,46813,2841,46813,60462800.0,338200,1826,141800,188613,125700,0.0
885,153876,415500,3028,116031,410592,332475,166350,42772,3829,42772,37636900.0,170900,2766,111104,153876,94300,0.0
579,16935,45686,41,11317,41754,38077,22626,4211,236,4211,2208300.0,121900,264,12724,16935,97900,0.0
702,34030,86551,289,23845,85107,72523,38849,10173,1418,10173,6765500.0,111200,574,23857,34030,182700,1.0
653,36742,88231,273,24989,87203,72683,41165,9523,873,9523,5743200.0,102300,723,27219,36742,196100,1.0
655,18939,46452,27,13027,45853,37166,21763,5640,326,5640,3380300.0,103700,240,13299,18939,120000,1.0
708,83897,207661,1421,60682,205980,171778,95135,20477,1606,20477,14478300.0,158600,1804,63420,83897,120900,0.0
940,97919,245801,839,73792,239154,201133,104360,28682,1666,28682,27728800.0,194100,985,69237,97919,217200,1.0
835,536439,1229605,55397,395492,1215219,1023555,596504,188427,12978,188427,163674600.0,140600,8335,348012,536439,301900,1.0
1138,21379,55687,723,14381,55290,46577,38899,3398,240,3398,3763200.0,183400,349,17981,21379,159000,0.0
714,14576,40570,54,10438,40254,32827,16320,3982,153,3982,2623600.0,154800,337,10594,14576,219400,1.0
738,17404,41716,26,11595,41421,34800,23291,3991,164,3991,2693900.0,159100,410,13413,17404,161100,0.0
654,35102,86847,125,24184,85418,70449,44858,9551,733,9551,5774000.0,108200,831,25551,35102,215100,1.0
723,110377,277794,2109,78916,272099,224050,120871,37418,3303,37418,27496300.0,124100,1863,72959,110377,85100,0.0
663,5947,14631,6,4028,14594,11921,7208,1277,98,1277,734600.0,156000,111,4670,5947,97600,0.0
627,9361,24448,17,6520,24203,19581,11125,2279,130,2279,1226400.0,143600,103,7082,9361,101200,0.0
662,58758,144287,415,40294,137432,119246,69737,14816,1160,14816,9387700.0,96200,1295,43942,58758,154000,1.0
764,10801,27760,51,7706,27511,22863,13469,2386,103,2386,1695200.0,163500,134,8415,10801,76300,0.0
871,38818,101589,145,28933,100343,83374,41819,8627,432,8627,7140100.0,197400,445,30191,38818,73800,0.0
639,28242,66737,197,18970,66207,55395,32773,6821,539,6821,3842400.0,98600,564,21421,28242,251100,1.0
695,14675,39321,5,10216,38733,32201,19198,4297,507,4297,2859600.0,124700,137,10378,14675,137500,1.0
807,25978,63987,130,18095,63160,52886,34703,5886,219,5886,4474600.0,141200,997,20092,25978,145700,0.0
942,57710,160646,3720,44510,156272,139168,65909,22283,2196,22283,22884000.0,212300,353,35427,57710,67300,0.0
636,39281,93038,28,27140,89131,76731,45377,11281,554,11281,6572800.0,112300,890,28000,39281,109800,0.0
997,113827,300941,2750,85116,298131,246901,122452,32287,1929,32287,32349700.0,209800,1405,81540,113827,107800,0.0
591,2196,4754,8,1317,4715,4051,4431,613,103,613,346400.0,73800,69,1583,2196,95700,1.0
604,21925,52880,93,14631,52137,43593,27558,5522,515,5522,3057100.0,85000,547,16403,21925,119100,1.0
663,70384,168161,1512,49994,166757,138796,79150,18775,1888,18775,12086600.0,129200,1553,51609,70384,72100,0.0
1171,235909,626486,10542,184087,620739,511295,248873,55239,3838,55239,66686400.0,315700,2617,180670,235909,80700,0.0
748,85907,211960,837,59331,208088,174130,98938,29551,2044,29551,21409500.0,149100,3549,56356,85907,133500,0.0
993,137239,360774,3571,103547,355811,288259,145096,47689,3408,47689,47915400.0,196000,1809,89550,137239,84000,0.0
623,17199,42070,176,12096,40024,34817,21243,4503,262,4503,2592000.0,77100,390,12696,17199,191600,1.0
624,54043,133160,192,34217,129734,110551,63551,14584,1739,14584,8089000.0,94600,1265,39459,54043,209700,1.0
623,15925,38747,40,10854,38353,32415,20329,4867,695,4867,2902000.0,109900,204,11058,15925,51400,0.0
1211,312805,818677,22649,246892,804641,660676,331100,87081,6337,87081,109240600.0,299300,4275,225724,312805,123400,0.0
620,31152,80539,74,20645,75111,67443,39057,7183,527,7183,4117000.0,90300,692,23969,31152,74600,0.0
637,14484,37338,2,9920,34890,31023,16675,3814,282,3814,2141000.0,108600,255,10670,14484,598900,1.0
810,52792,137616,447,39150,135907,109399,56952,16089,1014,16089,13357800.0,166600,861,36703,52792,155100,0.0
769,45991,115398,684,33385,112226,94349,53193,13846,1461,13846,10426600.0,147400,479,32145,45991,161700,1.0
742,128247,318222,1507,90231,310400,263281,149737,40533,2942,40533,28675200.0,124100,2853,87714,128247,174000,1.0
701,7423,18302,57,5150,17682,15100,8128,2130,148,2130,1370900.0,173800,84,5293,7423,280100,1.0
588,17095,40345,56,11403,39658,33432,23561,4069,494,4069,2215500.0,92200,348,13026,17095,213400,1.0
745,26564,66615,98,18636,65871,56128,29970,8228,551,8228,6495800.0,143300,404,18336,26564,209100,1.0
790,75596,185984,628,56172,183979,152227,81603,17966,1501,17966,15310000.0,190000,997,57630,75596,131700,0.0
547,13447,30781,106,9398,30450,25444,17706,2849,236,2849,1428200.0,97100,187,10598,13447,122100,1.0
608,18452,44258,90,12402,43723,35933,22633,4639,459,4639,2591600.0,96700,381,13813,18452,108200,1.0
957,198565,536494,3259,151956,530084,422045,208751,63197,3297,63197,62187600.0,193200,1684,135368,198565,533300,1.0
667,45805,113623,158,31018,109671,94086,52117,12289,1032,12289,7450900.0,114100,589,33516,45805,313100,1.0
760,17936,45878,92,13327,45351,37138,20707,3564,241,3564,2473600.0,164000,187,14372,17936,246600,1.0
653,6536,17070,2,3925,16832,13912,12981,1491,147,1491,895000.0,103700,410,5045,6536,231700,1.0
647,2648,6192,2,1532,5995,5577,6362,489,46,489,294800.0,148500,73,2159,2648,262300,1.0
709,16121,41550,113,10828,41133,34225,21738,4203,518,4203,2844300.0,139400,213,11918,16121,168300,1.0
767,65703,165707,114,45767,163863,133252,75249,18219,1293,18219,13383000.0,135900,1140,47484,65703,283800,1.0
617,3285,9402,58,1748,8262,7753,4480,1112,51,1112,574800.0,52100,163,2173,3285,233400,1.0
738,14893,37914,13,10437,37478,30562,18132,4049,249,4049,2709300.0,99700,159,10844,14893,206100,1.0
591,9054,26620,21,5929,23993,22350,10781,2284,184,2284,1203900.0,123000,282,6770,9054,218100,1.0
613,12384,32424,48,7908,32248,25839,14750,3093,440,3093,1555600.0,88900,401,9291,12384,161400,1.0
593,13573,34156,97,8353,32608,28164,17675,3413,242,3413,1567800.0,89900,262,10160,13573,181900,1.0
703,15134,37581,0,10317,36858,30177,19976,4118,697,4118,2250000.0,84600,292,11016,15134,276800,1.0
535,11911,31765,117,7313,31641,25037,14907,3703,428,3703,1527400.0,75800,396,8208,11911,335600,1.0
762,41417,107379,106,29640,103229,84274,47565,14557,883,14557,10693400.0,113200,581,26860,41417,133200,1.0
881,109251,281870,245,82978,278820,222961,121036,28779,2526,28779,24971800.0,148400,1724,80472,109251,212300,1.0
707,31354,75926,163,20353,75390,62303,39753,8482,1036,8482,5720900.0,153300,716,22872,31354,75700,0.0
603,8426,21788,22,5093,21485,17070,10525,2600,303,2600,1327000.0,76200,178,5826,8426,492300,1.0
1014,73168,204632,570,57213,199002,160255,80049,21953,1249,21953,21450100.0,164900,844,51215,73168,194800,1.0
1084,154049,387847,2924,116584,380893,317988,181326,60741,8145,60741,67665300.0,273100,3711,93308,154049,168000,0.0
647,26861,67572,50,17910,66826,54032,30631,8430,661,8430,4615900.0,84800,579,18431,26861,102400,1.0
918,24840,61065,175,15723,60500,50656,34628,5848,330,5848,4728900.0,178600,665,18992,24840,127300,0.0
566,9703,27505,35,6434,24436,22763,12021,3274,278,3274,1617000.0,60500,74,6429,9703,74200,1.0
893,95539,251664,483,76215,250153,196686,102383,27676,1493,27676,24926500.0,173600,1196,67863,95539,274300,1.0
716,76234,194174,182,53770,192782,154341,86796,22387,1651,22387,15691000.0,133900,914,53847,76234,101100,0.0
663,20480,56549,32,12663,56233,44742,24274,6034,829,6034,3470700.0,94300,302,14446,20480,210900,1.0
589,18303,46127,13,12365,45699,36960,21531,5160,194,5160,2455900.0,81200,401,13143,18303,144800,1.0
664,27022,69981,106,18490,68853,55855,31295,9657,999,9657,6406300.0,116300,444,17365,27022,91100,0.0
838,9715,27465,35,6961,26917,21984,11306,2978,335,2978,2626900.0,130700,32,6737,9715,153300,1.0
883,125168,310186,293,83096,308646,257775,198229,37682,19985,37682,32116400.0,166500,2293,87486,125168,151500,0.0
726,24711,63734,47,17423,63314,50640,28549,4602,274,4602,3012500.0,121200,444,20109,24711,193100,1.0
645,6501,17897,22,4054,16310,14557,7760,1637,117,1637,891800.0,69800,125,4864,6501,158800,1.0
668,33029,89116,79,21322,88419,71543,42673,10356,1535,10356,5819800.0,92700,757,22673,33029,86800,0.0
746,113191,297732,576,82640,293493,235497,126296,35088,2731,35088,24954800.0,128000,1914,78103,113191,188100,1.0
616,9392,24788,8,5897,24567,20183,12126,2156,55,2156,1169200.0,92600,248,7236,9392,164800,1.0
754,5587,14842,50,3472,14692,12097,7691,1343,115,1343,779800.0,65800,315,4244,5587,164600,1.0
1105,68790,179316,300,44753,171558,147722,96401,20297,2372,20297,22888500.0,283800,1647,48493,68790,171400,0.0
710,6150,14808,18,3892,14693,12280,7428,1272,73,1272,720000.0,103900,34,4878,6150,121000,1.0
543,10945,31073,0,6896,30739,23849,13733,3719,325,3719,1579700.0,67200,331,7226,10945,359800,1.0
658,7052,20228,0,4744,19971,16273,9357,1982,159,1982,1069700.0,93100,133,5070,7052,85800,0.0
922,149161,404869,1986,117415,381029,326933,169161,61180,6588,61180,56946200.0,154100,3341,87981,149161,81700,0.0
700,8878,22868,19,5623,22565,18932,11812,2271,201,2271,1406500.0,101100,312,6607,8878,163800,1.0
550,7129,20066,111,4434,18619,16091,9131,1730,230,1730,704300.0,75400,132,5399,7129,69900,0.0
831,185837,490332,953,140584,485740,387890,204777,63028,5403,63028,53119400.0,165600,3474,122809,185837,103300,0.0
729,31445,86544,101,20986,84630,69573,35336,6631,896,6631,4630600.0,169000,653,24814,31445,117100,0.0
1003,54028,151716,386,41839,148945,118191,59038,15639,1358,15639,15338700.0,177500,912,38389,54028,107000,0.0
722,52092,138537,199,37707,136996,108810,59722,17808,1786,17808,11870300.0,128400,793,34284,52092,93800,0.0
719,25543,66508,95,17861,65244,53453,31055,7299,409,7299,4810600.0,87400,469,18244,25543,118600,1.0
660,4077,9694,3,2252,8445,8623,5550,974,23,974,439800.0,116600,133,3103,4077,77400,0.0
730,46428,121449,570,33509,120761,100723,52957,14852,1243,14852,11192900.0,132300,833,31576,46428,240600,1.0
602,11564,27772,18,7572,27282,22596,14093,3441,289,3441,1837300.0,75600,110,8123,11564,90100,1.0
615,12310,32256,153,7772,30477,26231,15380,3241,325,3241,1414000.0,68400,82,9069,12310,311100,1.0
598,1179,2739,0,848,2608,2149,1375,264,40,264,133200.0,72300,9,915,1179,170800,1.0
621,3203,7133,4,2244,7092,5794,3561,522,55,522,243000.0,115800,42,2681,3203,282400,1.0
562,2424,5480,37,1742,5346,4362,3085,747,99,747,364100.0,85800,43,1677,2424,238500,1.0
501,984,3275,15,560,3228,2383,1331,366,32,366,151800.0,55800,8,618,984,235900,1.0
757,73762,183660,748,60460,180940,142007,78099,26863,1861,26863,20924300.0,166600,897,46899,73762,250800,1.0
849,3901,8519,27,2482,8219,7355,5018,670,60,670,497900.0,202600,121,3231,3901,277000,1.0
612,582,1373,11,353,1334,1146,719,112,14,112,52200.0,88100,21,470,582,209800,1.0
555,1510,3642,0,993,3579,2840,1811,335,65,335,176900.0,81100,19,1175,1510,371600,1.0
620,944,2327,0,574,2266,1877,1203,216,10,216,92300.0,85700,14,728,944,271300,1.0
505,2881,7277,0,1945,7035,5779,3388,681,52,681,319200.0,81300,62,2200,2881,296800,1.0
411,2327,5000,6,1551,4913,4038,2737,472,12,472,194500.0,105900,46,1855,2327,154500,1.0
614,2292,5502,28,1686,5352,4465,3033,659,100,659,382900.0,82400,35,1633,2292,286200,1.0
505,530,2048,0,405,2048,1343,614,308,21,308,139800.0,51400,4,222,530,153800,1.0
716,5302,13907,24,4493,13713,11728,5894,2567,170,2567,1942300.0,146400,104,2735,5302,131900,0.0
530,2567,5524,9,1771,5364,4443,3735,694,34,694,331500.0,86000,56,1873,2567,122700,1.0
542,1648,5709,5,1125,5664,3850,2015,685,41,685,326400.0,65700,9,963,1648,153600,1.0
518,1271,2940,7,828,2843,2284,1428,293,27,293,173100.0,80800,0,978,1271,161800,1.0
618,533,1281,0,368,1261,1031,693,154,4,154,44300.0,82300,7,379,533,166900,1.0
621,7391,17572,61,5939,16522,13874,7937,2611,194,2611,1656900.0,173400,61,4780,7391,136600,0.0
548,1019,2366,2,605,2270,1959,1403,210,21,210,107900.0,54500,39,809,1019,103300,1.0
572,3756,10250,30,2703,10061,7643,4990,1204,100,1204,701100.0,95700,38,2552,3756,155900,1.0
549,1050,2366,0,830,2303,1940,1251,276,13,276,128600.0,72800,16,774,1050,167100,1.0
545,601,1390,13,421,1390,1091,818,139,13,139,43900.0,122300,0,462,601,161600,1.0
895,18736,53147,14,15791,52863,39077,19567,3956,239,3956,3833700.0,209700,277,14780,18736,164700,0.0
509,1498,3303,13,985,3249,2674,1827,457,9,457,186000.0,115100,11,1041,1498,272100,1.0
552,4817,12350,0,3610,12205,9946,5721,1227,159,1227,795300.0,155200,0,3590,4817,206900,1.0
687,10902,25018,59,8164,24763,20990,13644,3906,363,3906,3118800.0,189200,167,6996,10902,124100,0.0
609,9283,22660,13,7030,21269,18459,9942,3219,188,3219,1941500.0,140400,75,6064,9283,225800,1.0
680,12011,27963,24,9484,27642,21980,12898,4187,227,4187,2984000.0,166500,115,7824,12011,252300,1.0
579,7651,18163,20,5919,17847,13713,8456,2522,70,2522,1452500.0,104800,241,5129,7651,152900,1.0
652,4172,10194,0,3033,10076,7994,4767,1062,67,1062,630600.0,123900,7,3110,4172,148700,1.0
421,1239,4177,5,792,4177,2834,1547,577,26,577,203300.0,53300,14,662,1239,163300,1.0
711,8696,19753,116,6551,19415,15676,9319,3413,75,3413,2661800.0,141000,266,5283,8696,231700,1.0
603,1579,3971,0,1116,3859,3158,2027,254,41,254,100100.0,114000,77,1325,1579,214000,1.0
511,690,1443,0,435,1443,1168,1018,102,5,102,39500.0,65900,28,588,690,93300,1.0
486,911,2034,13,582,1992,1601,1070,240,10,240,81200.0,77700,4,671,911,92400,1.0
557,955,3440,13,678,3400,2350,1136,374,16,374,187200.0,69000,14,581,955,88900,1.0
550,893,2084,0,564,2047,1600,1087,192,21,192,66000.0,78100,30,701,893,143500,1.0
664,1309,2994,5,1098,2994,2355,1516,277,17,277,165700.0,158300,17,1032,1309,103200,0.0
423,405,740,0,275,740,640,525,98,0,98,28400.0,77700,3,307,405,120400,1.0
837,11022,27066,33,8607,25767,21165,11759,2905,96,2905,2305200.0,168400,107,8117,11022,83400,0.0
645,1025,2318,0,713,2238,1896,1576,178,29,178,86500.0,81600,18,847,1025,90900,1.0
660,3523,8242,2,2537,8086,6513,4017,770,107,770,438500.0,110400,86,2753,3523,143900,1.0
651,16328,38637,51,12844,38089,30513,17762,5563,501,5563,3811500.0,152900,226,10765,16328,89900,0.0
500,3184,9319,10,2191,9069,6889,3885,1022,117,1022,437900.0,89900,84,2162,3184,98800,1.0
731,1061,3404,3,812,3402,2442,1184,124,9,124,49900.0,121300,22,937,1061,127400,1.0
586,2182,5515,0,1773,5369,4183,2518,545,80,545,290900.0,120700,33,1637,2182,86300,0.0
539,1813,4759,0,1325,4693,3733,2614,511,43,511,248900.0,106700,9,1302,1813,89700,0.0
475,683,2062,2,402,2026,1468,847,221,18,221,79600.0,45300,0,462,683,121700,1.0
550,2664,6496,0,1986,6440,5028,2863,644,81,644,313300.0,118900,6,2020,2664,110400,0.0
556,1311,2964,4,790,2920,2421,1803,340,23,340,135900.0,74300,10,971,1311,108500,1.0
790,43110,108126,149,32954,105356,84896,47577,13914,1059,13914,10923200.0,172400,476,29196,43110,94100,0.0
421,2768,10016,29,1830,9985,6363,3153,1616,159,1616,641800.0,38500,11,1152,2768,114000,1.0
781,6285,14929,11,4888,14800,11745,6846,1684,170,1684,1221500.0,161300,98,4601,6285,107600,0.0
497,990,2255,6,702,2211,1732,1273,213,16,213,88400.0,82000,40,777,990,80300,0.0
537,1383,3882,10,1059,3856,2905,1737,416,46,416,189700.0,81700,13,967,1383,88800,1.0
537,764,2837,3,526,2837,1990,994,356,30,356,169900.0,57100,0,408,764,86500,1.0
438,1835,4282,0,1331,4216,3407,2225,327,73,327,129000.0,112700,41,1508,1835,154400,1.0
579,2626,6478,0,1892,6347,5113,3223,697,31,697,343800.0,77300,24,1929,2626,87800,1.0
489,2554,6972,0,1706,5557,5883,2975,629,60,629,294500.0,80400,67,1925,2554,123100,1.0
568,2170,5280,7,1611,5121,4084,2534,694,37,694,328400.0,117100,3,1476,2170,82600,0.0
698,12602,33697,44,10592,33558,27645,14151,5090,429,5090,3777500.0,165100,77,7512,12602,79500,0.0
615,3115,6783,0,2001,6567,5778,4227,851,119,851,472400.0,116700,48,2264,3115,204500,1.0
526,1943,4209,0,1284,4156,3296,2528,589,47,589,282000.0,68600,35,1354,1943,189800,1.0
587,2193,5911,0,1733,5757,4220,2803,407,19,407,181500.0,117400,57,1786,2193,130500,1.0
589,11321,28137,9,7265,27646,22756,13232,3117,383,3117,1733700.0,86800,191,8204,11321,166000,1.0
690,5998,17097,0,4110,16966,13769,7086,1498,86,1498,912100.0,113800,122,4500,5998,102200,0.0
550,4721,11681,15,2794,11444,9451,6891,1248,39,1248,565400.0,91800,108,3473,4721,117400,1.0
971,273497,678322,7358,219346,671589,546674,299704,124766,10560,124766,124067100.0,194800,3609,148731,273497,87900,0.0
533,4566,11573,0,2491,11388,9736,5871,1096,98,1096,419800.0,107700,104,3470,4566,92700,0.0
574,10095,25945,10,5779,25601,20912,12044,2667,92,2667,1265000.0,87500,57,7428,10095,98200,1.0
554,3295,7882,0,1779,7736,6374,4645,595,89,595,268600.0,84200,66,2700,3295,88300,1.0
674,21619,52926,0,13691,52261,44161,25665,5345,688,5345,3380400.0,135900,581,16274,21619,65900,0.0
746,39615,103666,113,28446,102666,83131,42983,13495,801,13495,9692800.0,150100,585,26120,39615,76600,0.0
651,4818,11830,11,2795,11708,9664,5794,1002,160,1002,542200.0,118400,38,3816,4818,96500,0.0
686,24343,63465,46,16438,62687,50489,27095,8262,597,8262,5209900.0,131200,472,16081,24343,88400,0.0
613,7104,17944,0,4667,17708,14260,8420,2846,238,2846,1554600.0,104300,146,4258,7104,83800,0.0
654,2999,8188,8,1934,7983,6581,4222,684,35,684,393000.0,94900,92,2315,2999,124700,1.0
796,33332,87606,133,25255,86444,69001,36486,10441,689,10441,8325500.0,156000,494,22891,33332,147900,0.0
594,7268,19176,0,4714,19008,15402,9250,1776,236,1776,923500.0,114200,280,5492,7268,92300,0.0
609,10118,25813,20,6126,25398,21145,14095,2522,149,2522,1250800.0,107400,123,7596,10118,229800,1.0
931,68904,192120,749,55851,178128,145184,78320,28273,4442,28273,26595000.0,153700,1695,40631,68904,228500,1.0
736,19032,51341,133,13178,50838,40674,21411,5461,329,5461,3410100.0,146300,235,13571,19032,212600,1.0
669,7384,21639,0,4859,18782,18015,8975,1390,131,1390,744000.0,91600,126,5994,7384,173500,1.0
573,4894,13359,0,2788,13179,10715,6434,1224,139,1224,464100.0,82400,122,3670,4894,157600,1.0
627,17416,45698,8,10766,45185,36975,21106,4218,433,4218,2408000.0,115200,379,13198,17416,143800,1.0
611,13483,32263,2,8130,31806,26280,17157,3310,359,3310,1740400.0,97000,238,10173,13483,62300,0.0
547,14592,35262,0,9034,34979,28819,17540,4628,394,4628,2126400.0,107200,42,9964,14592,231600,1.0
668,5400,14554,0,3631,14342,11363,6412,1630,51,1630,994800.0,96700,184,3770,5400,118800,1.0
624,7362,19380,2,4785,19143,15546,9513,2466,246,2466,1374200.0,131100,289,4896,7362,153700,1.0
524,2164,7588,0,1350,4871,6601,2606,880,78,880,376500.0,75100,36,1284,2164,72400,0.0
839,182315,452286,1439,135897,448739,366908,200608,65422,5336,65422,53734200.0,169400,2982,116893,182315,66600,0.0
492,4663,11944,29,2929,11725,9691,5512,989,92,989,453700.0,88300,179,3674,4663,82400,0.0
624,20352,52569,59,12911,51800,42554,23388,5237,568,5237,3089000.0,123700,532,15115,20352,124900,0.0
690,12008,31753,19,8566,31417,25106,13436,3400,197,3400,2208800.0,119300,212,8608,12008,105200,0.0
584,12795,30659,22,8130,30243,24672,14638,4164,427,4164,2092500.0,87600,292,8631,12795,127100,1.0
637,12607,32478,6,8185,32102,25815,14585,3725,213,3725,2054700.0,114200,422,8882,12607,157600,1.0
517,8519,21949,11,5197,21619,17311,9980,2578,271,2578,1131100.0,86700,88,5941,8519,119000,1.0
768,21445,61434,85,16808,60611,47858,23612,6614,607,6614,4996000.0,142400,467,14831,21445,98000,0.0
719,30518,75538,17,20393,74641,61430,34864,9934,799,9934,6708100.0,134100,637,20584,30518,116900,0.0
654,15327,37751,2,10626,37227,29626,16825,5899,439,5899,3573400.0,98100,159,9428,15327,91900,0.0
490,7385,17940,9,4211,17709,14498,9016,1805,186,1805,715400.0,103700,143,5580,7385,107200,0.0
660,19280,49222,14,12881,48088,38650,22468,5842,545,5842,3538500.0,94800,447,13438,19280,92500,0.0
795,139037,354589,1586,100156,350600,288166,156016,49406,5911,49406,39479800.0,166100,2622,89631,139037,82700,0.0
621,8680,25784,2,5528,22096,21339,10945,2641,157,2641,1535200.0,85400,217,6039,8680,82800,0.0
740,20090,51024,36,12511,50654,42118,22571,4808,266,4808,3332000.0,193000,238,15282,20090,230200,1.0
672,7023,16722,0,4510,16488,13741,8591,1668,232,1668,892800.0,110900,91,5355,7023,104700,0.0
958,106673,298456,463,88863,296123,231426,112641,36739,2369,36739,35808500.0,174200,1230,69934,106673,153100,0.0
577,7535,19279,0,5245,19058,15241,8653,1902,142,1902,993300.0,120700,128,5633,7535,111600,0.0
628,9793,26394,0,6233,25982,21137,11725,2120,187,2120,1101100.0,97700,328,7673,9793,200700,1.0
950,47213,128874,507,37249,127842,101456,50381,10875,536,10875,10099900.0,227100,470,36338,47213,210900,0.0
633,66388,156519,128,43250,154897,129161,74580,18210,1114,18210,10665600.0,130300,982,48178,66388,124900,0.0
599,7613,17830,48,4736,17481,14940,8895,2100,116,2100,1140400.0,121200,79,5513,7613,72900,0.0
619,15755,40210,0,10504,39705,31748,17907,4961,423,4961,2565600.0,108600,376,10794,15755,82900,0.0
713,52684,126437,312,36843,124652,104361,59548,18621,1714,18621,13046700.0,152800,930,34063,52684,84900,0.0
590,13607,33776,20,9286,33341,27928,15591,4547,467,4547,2572700.0,94300,234,9060,13607,140500,1.0
606,6693,16154,14,3870,16002,13371,9078,1627,157,1627,807000.0,88700,211,5066,6693,88000,0.0
602,4664,14413,33,2822,13234,12302,5760,1131,129,1131,462300.0,129600,162,3533,4664,83500,0.0
571,15843,39824,11,9074,39285,32732,20639,4863,507,4863,2353800.0,92700,551,10980,15843,157300,1.0
633,5456,13839,0,3775,13653,11178,6107,1441,42,1441,789500.0,151800,28,4015,5456,78900,0.0
690,21576,54074,0,15170,53471,42655,23764,6951,259,6951,4745900.0,118000,315,14625,21576,159500,1.0
661,15084,39336,2,10729,38844,32298,16576,3056,108,3056,1982600.0,185000,121,12028,15084,98800,0.0
401,2704,6605,37,1560,6440,5401,3618,610,55,610,189200.0,83500,167,2094,2704,93700,1.0
613,23375,56402,136,14479,55776,46049,27060,6073,357,6073,3503800.0,115400,705,17302,23375,160700,1.0
491,6936,17846,31,3737,15947,15207,9000,1631,60,1631,583200.0,114100,233,5305,6936,117100,0.0
666,13653,33543,55,9352,33191,26950,15428,3749,117,3749,2495400.0,117500,311,9904,13653,89600,0.0
585,9158,23239,0,5967,22892,18219,10133,2435,63,2435,1259500.0,111700,120,6723,9158,82600,0.0
632,2613,6302,0,1706,6195,5222,2999,418,119,418,224700.0,166000,0,2195,2613,62500,0.0
851,25065,68575,114,19593,67688,53703,26808,6317,149,6317,5215700.0,163100,323,18748,25065,95200,0.0
622,16325,41397,0,11099,41048,33898,19145,4310,382,4310,2436200.0,120600,389,12015,16325,125700,1.0
744,49939,127135,114,35345,125993,104133,56732,12567,1135,12567,9017100.0,169500,887,37372,49939,70800,0.0
948,14671,39713,64,10975,39386,31686,15997,3072,193,3072,2697400.0,170500,420,11599,14671,125400,0.0
606,23798,56500,25,14887,55450,47018,28023,7142,365,7142,3763100.0,114600,403,16656,23798,91500,0.0
604,9112,22942,43,5743,22795,18797,11015,2051,175,2051,1017400.0,110600,63,7061,9112,186700,1.0
627,11599,29024,0,7571,28614,23622,13942,3513,338,3513,1948100.0,120400,355,8086,11599,242600,1.0
634,9725,26497,46,6581,23619,21084,11315,4135,339,4135,2321800.0,81000,127,5590,9725,336400,1.0
621,16101,42591,27,10458,42143,33070,18206,4214,218,4214,2319400.0,98800,324,11887,16101,274900,1.0
837,37110,97887,344,26146,96630,78140,42811,13599,1715,13599,10804700.0,126100,835,23511,37110,162100,1.0
665,11393,28355,0,7621,27992,23189,13188,2882,374,2882,1486900.0,121200,157,8511,11393,303200,1.0
500,8937,21995,16,5327,21715,17599,10348,1909,87,1909,821900.0,114700,102,7028,8937,213000,1.0
457,2180,5071,0,1383,4983,4260,3481,409,55,409,133200.0,129700,52,1771,2180,117600,0.0
930,64600,175730,378,50017,174148,138282,69146,17115,1018,17115,16025800.0,194900,837,47485,64600,227700,1.0
503,5860,16713,0,3615,14687,14045,7318,1145,140,1145,445700.0,96400,105,4715,5860,143500,1.0
613,2944,8773,3,2053,8684,7097,3483,843,54,843,487600.0,128000,128,2101,2944,188300,1.0
1364,73160,212161,346,60198,211662,160261,76485,14228,757,14228,19125000.0,388400,709,58932,73160,355100,0.0
734,17058,46854,25,12680,46458,35933,18784,5427,558,5427,3770800.0,129700,256,11631,17058,361300,1.0
501,3171,7684,0,1667,7591,6358,4324,812,93,812,266100.0,90300,53,2359,3171,175600,1.0
572,27319,68520,0,17376,67319,56839,32419,7455,683,7455,3859900.0,114600,617,19864,27319,128200,1.0
666,25114,58178,31,13861,57531,48840,29072,5487,518,5487,3395200.0,140800,805,19627,25114,104300,0.0
894,349207,937847,5489,268709,925195,726932,403206,154003,19090,154003,140377800.0,135700,4867,195204,349207,173200,1.0
402,2156,5675,14,1390,5573,4738,2681,268,104,268,87600.0,95000,31,1888,2156,146200,1.0
588,12996,31566,7,7712,30973,26291,15261,3762,272,3762,1751600.0,102700,253,9234,12996,347000,1.0
632,10827,27889,21,7134,27562,22115,12944,2996,476,2996,1542400.0,92700,149,7831,10827,115500,1.0
666,8930,24502,28,5881,22982,19892,10410,1932,155,1932,1054500.0,104800,139,6998,8930,162600,1.0
632,7064,18281,0,4452,18064,14821,8952,1632,147,1632,929300.0,103000,281,5432,7064,187000,1.0
669,20088,52887,61,13258,51964,43413,23968,5337,392,5337,3290100.0,136700,471,14751,20088,200100,1.0
652,30624,75565,20,20337,74695,61624,33444,12097,519,12097,7795400.0,152800,401,18527,30624,114300,0.0
683,5505,14654,14,3553,14423,11841,6461,1352,91,1352,801200.0,138100,137,4153,5505,94000,0.0
734,36901,95523,155,26850,94605,77798,56894,12040,6202,12040,8532800.0,164000,675,24861,36901,152400,0.0
628,5315,13248,15,3309,13023,10795,6841,1546,106,1546,892300.0,130400,224,3769,5315,95400,0.0
781,20739,55993,36,14806,55503,43706,24020,3982,638,3982,2995200.0,113100,553,16757,20739,99000,0.0
555,2128,5806,0,1376,4986,4936,3443,473,63,473,197300.0,49200,63,1655,2128,119600,1.0
837,11032,36491,57,8142,31487,29400,13135,3524,535,3524,2609700.0,85700,455,7508,11032,151800,1.0
633,6245,16966,0,3728,16865,13574,9668,1348,136,1348,735000.0,102300,716,4897,6245,224600,1.0
534,1833,4887,0,1083,4716,3872,2930,280,21,280,123000.0,111200,27,1553,1833,328300,1.0
776,8044,19406,46,5395,19080,15487,10246,2260,131,2260,1438100.0,107100,239,5784,8044,155200,1.0
652,4781,14187,24,2817,13986,11786,7252,824,68,824,233800.0,73300,372,3957,4781,52100,0.0
721,9032,23574,48,6297,23336,18468,11094,2037,169,2037,1129400.0,97200,65,6995,9032,90500,0.0
781,3731,14791,0,2750,12341,11861,4629,1057,88,1057,774200.0,52900,48,2674,3731,76700,1.0
549,3811,10429,6,1999,10336,8813,8171,458,51,458,220400.0,92100,298,3353,3811,295600,1.0
675,1063,3067,7,821,3027,2459,1403,203,15,203,121100.0,86800,26,860,1063,64000,0.0
651,2602,7541,6,1688,6891,5878,3197,788,62,788,470000.0,70800,49,1814,2602,95300,1.0
826,31781,90322,18,22941,89490,71013,37377,9635,954,9635,7548700.0,105000,504,22146,31781,154400,1.0
695,4730,12670,23,3266,12606,9703,5732,1385,138,1385,981000.0,83600,56,3345,4730,73300,0.0
716,1924,5532,9,1394,5453,4091,2334,520,24,520,310500.0,93500,35,1404,1924,133700,1.0
1018,51990,150889,136,40954,148797,116271,55714,12771,1079,12771,13255600.0,175000,610,39219,51990,288900,1.0
669,4076,10369,0,2762,10295,8439,5202,597,108,597,285400.0,87200,126,3479,4076,107700,1.0
742,1754,5821,0,1288,4283,4705,1965,687,6,687,459700.0,146900,46,1067,1754,84700,0.0
690,12674,35098,4,8692,34422,27893,16259,3324,362,3324,2033200.0,93700,673,9350,12674,49600,0.0
680,8100,23480,3,5265,22556,18724,10635,1991,115,1991,1166700.0,84800,284,6109,8100,63600,0.0
763,23825,65411,39,17521,64597,51528,28229,10517,1259,10517,7621900.0,117700,221,13308,23825,174900,1.0
667,3222,9871,40,2439,9784,7337,3793,1001,28,1001,572600.0,86200,126,2221,3222,76700,0.0
949,43942,125963,103,33826,124149,98694,48857,9880,713,9880,8860300.0,180900,745,34062,43942,118700,0.0
523,2589,7191,28,1441,7191,5360,3994,1046,150,1046,450400.0,50700,100,1543,2589,142700,1.0
688,15189,48976,71,11556,46436,36457,18976,5597,592,5597,3967300.0,94500,134,9592,15189,101000,1.0
586,735,2257,0,538,2248,1804,1020,245,32,245,151200.0,57000,0,490,735,150100,1.0
971,51475,155744,303,42542,154456,113768,57014,17481,2027,17481,16395300.0,120800,596,33994,51475,79600,0.0
741,1715,6739,0,1357,4797,5752,2235,600,36,600,260100.0,77500,24,1115,1715,165800,1.0
906,475,1420,0,353,1420,1142,559,134,0,134,34800.0,193600,4,341,475,89800,0.0
657,8980,27358,0,6430,23840,21896,11138,1997,313,1997,1166000.0,110100,277,6983,8980,102200,0.0
1172,447561,1176584,20180,374952,1169148,935214,487519,213336,17698,213336,262956900.0,275800,4627,234225,447561,113900,0.0
1225,323905,914075,5241,278828,911167,697176,340142,111349,8786,111349,145403100.0,265300,2880,212556,323905,125300,0.0
774,30931,87700,101,22259,85494,67484,36565,10507,1173,10507,7826200.0,97300,561,20424,30931,33500,0.0
620,1099,3026,0,839,2958,2352,1488,216,34,216,83700.0,55800,11,883,1099,86600,1.0
288,664,1498,2,463,1498,1160,1060,230,31,230,74700.0,44700,32,434,664,79800,1.0
1047,68045,194843,790,55460,193130,154278,73347,25803,2140,25803,28108100.0,204700,776,42242,68045,172300,0.0
644,4790,13368,8,3483,13156,9956,6084,1391,95,1391,664000.0,62700,233,3399,4790,129800,1.0
705,1276,3495,0,919,3447,2660,1544,341,56,341,196100.0,92400,20,935,1276,98300,1.0
930,31,74,0,22,74,67,59,15,0,15,5400.0,-666666666,0,16,31,115800,1.0
773,13811,36744,144,9919,36298,28379,19203,4452,689,4452,3183700.0,102200,387,9359,13811,86200,0.0
819,4420,15804,35,3350,13716,12451,5645,1345,130,1345,897500.0,68600,34,3075,4420,113800,1.0
668,6298,16727,0,4494,16522,13123,8658,1607,293,1607,894400.0,93900,726,4691,6298,110300,1.0
1283,30365,90414,327,25009,89661,68165,31853,5951,402,5951,7761500.0,225400,537,24414,30365,131000,0.0
730,17982,53026,0,13187,48169,42019,21472,4305,245,4305,2704500.0,111200,262,13677,17982,96000,0.0
846,49443,135371,290,38259,130082,105479,56978,20291,2383,20291,17240800.0,112400,1032,29152,49443,129400,1.0
425,712,1541,0,410,1530,1283,1063,192,23,192,64000.0,68600,20,520,712,127200,1.0
723,5934,14481,26,3170,14363,11898,8909,1318,50,1318,737600.0,75300,107,4616,5934,118600,1.0
838,21294,70818,28,14457,55328,61329,25465,10053,806,10053,9003800.0,132200,267,11241,21294,112500,0.0
755,16122,43315,52,9508,42388,35834,21128,3157,530,3157,1995700.0,117000,294,12965,16122,176300,1.0
874,8278,21316,10,5169,21125,18000,11788,1271,66,1271,912700.0,165900,253,7007,8278,176400,1.0
822,9529,24832,0,5803,24416,20790,16002,2490,597,2490,1862400.0,158900,326,7039,9529,123300,0.0
749,2282,7064,0,1676,5745,5739,2938,1028,132,1028,779500.0,81000,41,1254,2282,127100,1.0
492,1000,2932,7,685,2899,2202,1359,239,18,239,90900.0,33300,3,761,1000,151900,1.0
548,1574,3238,0,1018,3132,2670,2693,453,16,453,218900.0,81800,75,1121,1574,105600,1.0
1078,47253,129100,102,34952,127955,102906,53692,11648,1154,11648,12381500.0,244100,747,35605,47253,140500,0.0
928,22424,75818,57,17545,58228,59282,26325,9508,1096,9508,8225400.0,107700,523,12916,22424,143000,1.0
814,1358,4152,0,1141,4101,3009,1656,429,62,429,306900.0,130700,51,929,1358,107500,0.0
650,8328,22849,0,4803,19679,18933,11629,2607,215,2607,1534000.0,80200,404,5721,8328,104200,1.0
740,6725,22016,42,5853,21821,15829,8020,2431,197,2431,1753800.0,106400,70,4294,6725,155700,1.0
761,17326,48239,77,12527,47450,37133,20641,5437,421,5437,3589100.0,88900,402,11889,17326,125500,1.0
747,43453,121230,443,33488,114375,91067,49395,18547,2247,18547,14552600.0,89000,530,24906,43453,94700,1.0
538,3202,8403,0,1709,8152,6887,5414,665,126,665,250700.0,81900,93,2537,3202,93600,1.0
737,5838,17346,22,4138,15835,13400,7184,1511,425,1511,978700.0,89800,354,4327,5838,133100,1.0
628,1257,3348,0,834,3322,2619,1761,265,68,265,152300.0,78900,28,992,1257,154100,1.0
525,16320,63420,82,11845,62893,44771,19724,4184,520,4184,1866300.0,67200,285,12136,16320,165000,1.0
508,458,1084,0,304,1029,838,810,110,13,110,28800.0,53700,23,348,458,121900,1.0
643,1308,3575,5,964,3515,2596,1623,354,26,354,180700.0,62900,9,954,1308,100000,1.0
932,26015,80306,77,19262,78172,62076,30195,6104,317,6104,5125500.0,150300,875,19911,26015,67200,0.0
691,13835,37787,52,9055,36768,30164,18638,3797,561,3797,2462900.0,95100,282,10038,13835,95700,0.0
547,1244,3102,0,780,3039,2469,1925,465,39,465,219600.0,48700,49,779,1244,123800,1.0
872,8531,32729,0,6083,25162,26581,10693,3156,193,3156,2406200.0,78500,47,5375,8531,122900,1.0
746,3931,10639,18,2441,10535,8401,5825,1002,161,1002,586500.0,130300,98,2929,3931,113100,0.0
747,4530,19110,13,3372,15933,14938,5939,1356,178,1356,892900.0,75900,102,3174,4530,93000,1.0
702,1479,4836,34,1187,4732,3445,1670,321,57,321,199700.0,81500,0,1158,1479,125000,1.0
823,7748,20473,17,5344,20019,16296,9165,1990,64,1990,1501800.0,136800,72,5758,7748,95900,0.0
721,3143,8145,0,2132,8003,6496,4302,745,77,745,429200.0,82000,137,2398,3143,106200,1.0
804,1622,4122,0,1088,4111,3490,2682,437,37,437,202100.0,156400,30,1185,1622,89000,0.0
488,832,2224,2,501,2082,1806,1361,237,11,237,70800.0,54200,17,595,832,132000,1.0
855,6118,16850,0,4343,16362,13569,7688,1379,127,1379,852400.0,138300,234,4739,6118,130800,0.0
987,689921,1983675,5501,565488,1967683,1509967,748333,271069,30244,271069,281045300.0,158200,9577,418852,689921,161600,0.0
748,16567,57747,39,11509,44367,47733,20304,4819,502,4819,3277100.0,91800,180,11748,16567,63900,0.0
960,54725,164092,312,43871,162784,124774,58592,14747,857,14747,14147800.0,158200,628,39978,54725,185700,1.0
815,5232,14756,121,3863,14510,11345,6634,1582,263,1582,1108100.0,96700,210,3650,5232,141200,1.0
802,20580,50761,6,12605,49833,42025,24261,5920,475,5920,4458900.0,164000,717,14660,20580,77300,0.0
642,9437,24479,27,6097,23977,18978,11409,2993,178,2993,1683900.0,88500,173,6444,9437,107600,1.0
517,5107,13492,0,3061,13279,10709,7303,1105,104,1105,466900.0,89600,90,4002,5107,64400,0.0
517,5405,17289,64,3090,15547,14087,7741,1474,131,1474,611600.0,63000,146,3931,5405,182600,1.0
602,2022,7251,0,1386,6709,5442,3051,779,73,779,361000.0,61900,24,1243,2022,161500,1.0
802,11021,29292,8,7929,29021,23129,13132,2846,51,2846,2084000.0,175200,267,8175,11021,106600,0.0
474,152,564,0,119,564,408,253,109,0,109,19600.0,21300,0,43,152,144700,1.0
948,128857,358484,2123,98865,353545,278889,146962,54392,4285,54392,51991200.0,122400,1876,74465,128857,160000,1.0
690,7603,20913,101,5084,20568,16580,10626,1363,265,1363,856700.0,116700,656,6240,7603,90000,0.0
886,23246,66867,63,18034,66062,50687,27492,7700,551,7700,6703800.0,105400,143,15546,23246,198400,1.0
695,4333,11246,0,2588,11180,9085,5341,987,99,987,634700.0,114000,15,3346,4333,56900,0.0
882,49118,130552,193,38418,129640,102320,53955,14815,1630,14815,13308400.0,157600,885,34303,49118,76400,0.0
797,1123,3358,0,551,3262,2837,2693,261,57,261,148100.0,105100,70,862,1123,298800,1.0
657,2135,5851,0,1280,5182,4812,3184,697,57,697,220200.0,97000,70,1438,2135,51800,0.0
483,1102,3122,10,800,3122,2340,1500,255,12,255,117900.0,72900,58,847,1102,64700,0.0
919,462,1139,0,329,1098,858,609,69,7,69,35900.0,66100,13,393,462,-666666666,1.0
541,3536,12152,16,2364,11926,8983,4336,1084,101,1084,459600.0,39900,44,2452,3536,91800,1.0
766,7733,21821,33,5770,21606,16980,11837,2275,398,2275,1557500.0,114900,213,5458,7733,129400,1.0
711,2292,6033,4,1724,5997,4683,2784,344,59,344,201800.0,107800,40,1948,2292,101600,0.0
517,562,1414,0,360,1377,1187,899,111,28,111,50200.0,47400,22,451,562,63000,1.0
672,7232,19646,7,4836,17995,15723,9385,1823,324,1823,1039700.0,86100,473,5409,7232,93100,1.0
648,2755,7510,0,1787,7385,6155,3754,499,85,499,222800.0,130900,29,2256,2755,84200,0.0
607,3157,8220,0,1906,7976,6706,4558,768,79,768,352500.0,108500,104,2389,3157,76000,0.0
523,1533,3990,0,1024,3979,3168,2286,383,29,383,151300.0,38400,73,1150,1533,67200,1.0
634,2639,8774,7,1930,6353,7286,4061,634,192,634,357500.0,65700,304,2005,2639,90400,1.0
676,10675,32664,57,8237,32409,24183,12235,3512,506,3512,2419700.0,96300,208,7163,10675,102700,1.0
613,664,1591,0,419,1591,1309,988,160,22,160,79200.0,65700,5,504,664,92400,1.0
663,7684,19859,21,5182,19394,15670,10401,1883,130,1883,1088600.0,143300,132,5801,7684,162000,1.0
806,25974,79884,78,18682,73111,61948,30274,6534,601,6534,4735800.0,93200,518,19440,25974,87500,0.0
724,4142,12755,12,2944,11602,9641,4857,1248,119,1248,762000.0,68000,62,2894,4142,167700,1.0
945,21691,63247,38,16194,62217,49107,24398,5049,260,5049,4188400.0,141700,450,16642,21691,110900,0.0
785,13827,41016,30,10245,40492,33376,17696,5024,908,5024,3768300.0,128300,788,8803,13827,66000,0.0
1012,117088,345995,230,95779,334943,263673,130392,32872,3157,32872,32427800.0,164300,2310,84216,117088,131900,0.0
601,469,1114,4,295,1114,876,767,133,2,133,43400.0,57300,72,336,469,109800,1.0
612,1230,3433,0,776,3365,2838,2145,315,59,315,179300.0,65100,47,915,1230,96100,1.0
797,15509,48139,15,11764,47655,35977,18141,3972,277,3972,2611700.0,96100,242,11537,15509,104900,1.0
663,3470,8422,1,2133,8382,6857,5531,1003,51,1003,581300.0,65900,72,2467,3470,99300,1.0
627,5552,14990,0,3811,14797,11648,7084,1707,490,1707,991900.0,66100,355,3845,5552,93700,1.0
597,890,3702,0,504,3116,2901,1559,225,30,225,96000.0,44100,17,665,890,113500,1.0
732,15154,48548,47,11013,46087,38467,18386,2706,288,2706,1826900.0,134400,201,12448,15154,127300,0.0
801,3954,11498,0,3085,11375,8685,4755,1187,66,1187,768500.0,85600,54,2767,3954,70500,0.0
778,30459,79687,37,19717,78709,64449,40655,7491,555,7491,5136200.0,99000,1060,22968,30459,183500,1.0
743,23363,66606,0,16777,65852,51491,28332,6035,615,6035,4077500.0,115100,509,17328,23363,115900,0.0
604,964,2123,0,577,2070,1762,1789,321,33,321,126000.0,60800,43,643,964,97400,1.0
670,19085,49401,19,12904,48753,38914,22663,6812,856,6812,4503400.0,88100,518,12273,19085,125700,1.0
742,9298,24963,22,6241,24504,20450,13934,1746,352,1746,1157200.0,158700,2033,7552,9298,95100,0.0
1172,170051,508313,2018,139972,504499,387318,181263,52841,5611,52841,64823700.0,227100,2273,117210,170051,106300,0.0
589,1941,4432,0,1307,4373,3704,3302,483,73,483,211600.0,107200,16,1458,1941,96100,0.0
800,1635,5547,0,1338,5477,4001,1897,374,0,374,186600.0,120500,65,1261,1635,160300,1.0
735,76740,213849,338,54684,210417,165664,86218,28601,2992,28601,21147000.0,140700,1535,48139,76740,133200,0.0
488,2920,14291,62,1961,14272,9546,3633,1384,111,1384,633600.0,18700,10,1536,2920,95600,1.0
675,17632,46974,154,11236,43531,38405,24700,4109,427,4109,2577400.0,84900,482,13523,17632,78600,0.0
673,2694,7293,0,1783,7116,5749,3734,747,22,747,355300.0,80800,61,1947,2694,110100,1.0
774,19354,53607,12,12893,52941,42858,23169,4428,524,4428,2986400.0,112600,419,14926,19354,113200,0.0
813,12894,40544,0,9722,38735,32121,14260,4222,215,4222,3340500.0,124300,173,8672,12894,102300,0.0
638,5155,12972,0,3649,12790,10349,6267,1812,179,1812,1113300.0,69900,84,3343,5155,105700,1.0
763,1171,3735,0,956,3698,2804,1326,348,41,348,237500.0,88400,0,823,1171,137200,1.0
735,2652,8481,0,2036,8481,5934,3026,598,155,598,372800.0,81900,4,2054,2652,190500,1.0
644,11217,34527,43,8706,32742,25947,13425,4443,487,4443,2531000.0,80200,208,6774,11217,100000,1.0
568,9218,25689,43,6020,25497,19650,12084,2638,209,2638,1252300.0,73100,152,6580,9218,242100,1.0
602,5218,12353,1,3183,12139,10251,6903,1262,163,1262,619400.0,65200,122,3956,5218,109400,1.0
600,3781,10266,0,2547,10041,8121,5267,1067,70,1067,553500.0,76500,121,2714,3781,109800,1.0
719,9414,27436,0,5800,27289,21730,13444,1602,112,1602,1026800.0,95900,278,7812,9414,105100,1.0
631,1573,3894,0,1228,3874,3053,2104,500,13,500,294500.0,95500,50,1073,1573,246600,1.0
832,43081,116906,78,32777,112051,92228,47970,15912,1319,15912,13090800.0,122600,763,27169,43081,216500,1.0
749,14061,40506,40,9912,39952,31969,16949,3238,242,3238,2146700.0,111600,336,10823,14061,254900,1.0
864,32734,91518,362,24677,90445,70606,36507,11276,1405,11276,9794900.0,129100,338,21458,32734,135900,1.0
853,14698,48443,174,11636,48192,38142,16521,4614,555,4614,3813900.0,157600,349,10084,14698,110900,0.0
727,15224,41430,69,11187,41070,31766,17444,4955,376,4955,3227600.0,115700,206,10269,15224,105800,0.0
770,48528,131778,365,35892,116552,105041,55948,18769,2784,18769,14598200.0,93200,822,29759,48528,230600,1.0
895,15755,47205,0,12100,46503,37010,17334,2598,90,2598,1898600.0,170600,180,13157,15755,271400,1.0
675,248,602,0,161,602,459,428,65,14,65,25900.0,106900,14,183,248,171700,1.0
673,8065,23273,10,5981,23073,17868,9326,2532,260,2532,1614400.0,82300,157,5533,8065,149500,1.0
674,4457,10140,0,2567,9997,8444,6321,929,107,929,556400.0,88600,132,3528,4457,330400,1.0
628,16416,57471,59,12360,57072,41270,18233,5246,552,5246,3144300.0,95100,64,11170,16416,194900,1.0
1180,55045,159883,186,46196,158620,119137,59092,18295,1546,18295,21913400.0,187400,389,36750,55045,180400,0.0
814,47550,126146,193,34030,124699,99376,54921,15687,1168,15687,12584300.0,116600,830,31863,47550,72300,0.0
765,3586,12043,0,2307,10509,9841,6179,627,131,627,358200.0,84900,154,2959,3586,70800,0.0
819,8681,20195,0,4509,19985,17717,14956,2034,192,2034,1661700.0,184500,356,6647,8681,100200,0.0
742,10441,28109,51,7279,27826,22267,15425,3110,385,3110,2163400.0,88600,441,7331,10441,161400,1.0
732,12027,33787,0,8282,30882,27453,14327,3050,263,3050,1920500.0,98200,403,8977,12027,122700,1.0
698,4303,15051,6,2869,12462,12227,5880,1103,449,1103,668200.0,94100,5,3200,4303,104600,1.0
728,7260,20474,0,5084,18636,16273,9201,1795,109,1795,1200900.0,100000,97,5465,7260,65200,0.0
895,77480,214231,2413,64135,210275,174720,85634,42233,4233,42233,41814900.0,170500,1026,35247,77480,80100,0.0
720,5291,13660,0,2935,13569,10827,6637,939,176,939,575800.0,76500,119,4352,5291,122600,1.0
585,11811,30118,25,7154,29687,23988,14504,2615,292,2615,1486600.0,86200,115,9196,11811,127000,1.0
697,5716,19889,0,4495,19774,13438,6415,1352,147,1352,668100.0,111000,63,4364,5716,121900,1.0
814,45615,123402,69,34929,121202,94898,51560,18771,2010,18771,15622200.0,130000,675,26844,45615,79800,0.0
746,7971,22962,0,5613,21392,17671,10052,1976,636,1976,1312200.0,71700,169,5995,7971,100800,1.0
790,4174,13979,0,2789,9894,11504,5228,1105,54,1105,688400.0,101700,26,3069,4174,94600,0.0
882,110275,298042,1246,87621,293628,233768,123178,48581,5984,48581,44615200.0,122700,1234,61694,110275,115200,0.0
704,3075,8839,0,2123,7666,7209,4137,551,61,551,316400.0,81400,79,2524,3075,57700,0.0
933,36525,114852,147,29038,113768,86327,40073,8350,653,8350,7503400.0,154000,702,28175,36525,62500,0.0
1123,13691,40306,19,10166,39829,31867,15406,3716,259,3716,4405100.0,297700,336,9975,13691,121000,0.0
685,7027,17955,4,4630,17584,14532,9698,1592,160,1592,942800.0,106700,313,5435,7027,83200,0.0
698,2320,5953,19,1638,5908,4556,2978,633,61,633,374600.0,60500,10,1687,2320,98500,1.0
942,627889,1892004,22303,494842,1861276,1452689,683786,259072,24555,259072,250131300.0,142300,7641,368817,627889,71600,0.0
811,2230,7098,0,1709,6920,5249,2673,621,0,621,433800.0,68000,78,1609,2230,89000,1.0
889,13320,39283,19,9823,39077,29585,14915,2297,275,2297,2031600.0,171500,252,11023,13320,127500,0.0
472,1644,3602,0,912,3526,2891,2657,371,28,371,183300.0,67200,13,1273,1644,87800,1.0
886,116397,336506,651,92751,315444,251717,136088,52630,9135,52630,47300500.0,137100,3090,63767,116397,110800,0.0
683,122188,420201,826,86138,417802,302842,148211,40120,5395,40120,25859400.0,82500,1884,82068,122188,100200,1.0
1109,275164,781321,3698,238845,776789,603182,290621,97642,6750,97642,114042900.0,232000,2524,177522,275164,80100,0.0
778,32272,83909,67,23561,83143,65377,36649,7963,710,7963,5432700.0,104700,756,24309,32272,185300,1.0
726,7799,21704,0,5544,21569,16754,10608,1597,147,1597,905900.0,75500,282,6202,7799,84400,1.0
854,12205,34667,16,7979,34000,28205,15860,2807,643,2807,2367700.0,163400,1028,9398,12205,284200,1.0
673,5024,12530,13,3377,12381,9985,6044,1292,117,1292,795700.0,82300,52,3732,5024,420500,1.0
574,3361,9365,20,2323,8801,7542,4936,708,100,708,337000.0,73400,171,2653,3361,218300,1.0
820,2524,7777,0,2037,7679,5801,3004,550,24,550,398500.0,58200,123,1974,2524,336200,1.0
976,1562813,4525519,57534,1294543,4504029,3430347,1714340,707184,74066,707184,740255200.0,154100,20154,855629,1562813,296600,1.0
997,5413,17577,0,4506,17478,12732,6164,1432,126,1432,1310100.0,126000,84,3981,5413,357300,1.0
842,16545,45017,39,11055,44582,36360,21951,3935,356,3935,3144800.0,171100,403,12610,16545,402800,1.0
869,10795,25939,59,6724,25538,21443,13023,2561,186,2561,2111600.0,269900,399,8234,10795,292200,1.0
638,7018,20558,111,5126,20264,15605,8882,2196,239,2196,1250100.0,92900,76,4822,7018,136000,1.0
984,906179,2552213,34596,743266,2532552,1939466,985738,448928,39824,448928,471532500.0,148300,9090,457251,906179,194300,1.0
663,2147,5785,2,1536,5754,4421,2674,672,49,672,301500.0,76800,47,1475,2147,95600,1.0
529,194,600,0,142,600,444,372,51,21,51,25700.0,74700,13,143,194,83400,1.0
625,7066,18166,0,5030,17861,14271,8684,1536,90,1536,830500.0,87500,39,5530,7066,191300,1.0
523,4457,14415,0,3191,14378,9987,6344,1235,242,1235,437200.0,60700,39,3222,4457,127700,1.0
934,55467,160173,96,42662,157616,123094,60389,14486,1075,14486,12843100.0,132000,946,40981,55467,83000,0.0
896,21527,55418,48,13793,54684,44906,26004,5154,704,5154,4749800.0,170800,839,16373,21527,150400,0.0
746,13287,35929,42,9630,35468,27820,15319,4078,495,4078,2714800.0,97200,130,9209,13287,108700,1.0
805,88208,245720,456,68096,241367,191463,98823,37068,2789,37068,30234500.0,125200,1170,51140,88208,81300,0.0
734,3549,10484,0,2931,10419,7551,4067,987,190,987,679600.0,102400,48,2562,3549,113800,1.0
700,101,289,0,92,289,223,144,81,0,81,24200.0,38800,6,20,101,382900,1.0
494,1376,3753,0,933,3608,2842,2046,266,69,266,103400.0,44400,66,1110,1376,108700,1.0
684,17885,51594,0,12798,49083,39819,21167,4713,649,4713,2798200.0,98200,512,13172,17885,185100,1.0
654,791,3858,0,470,2587,3376,1648,227,7,227,87700.0,109800,48,564,791,278100,1.0
565,2035,5172,11,1354,5099,4127,2473,464,43,464,253700.0,73100,67,1571,2035,97200,1.0
463,634,2111,0,383,2100,1833,1680,83,23,83,19800.0,72800,12,551,634,91600,1.0
566,6437,18278,0,3809,18001,14878,10272,1620,216,1620,674100.0,59800,504,4817,6437,193800,1.0
713,5635,19969,0,3754,12740,16915,7292,1473,119,1473,785000.0,73100,157,4162,5635,144700,1.0
676,1007,2236,0,556,2173,1879,1729,198,23,198,112100.0,111300,97,809,1007,225500,1.0
500,1587,5262,19,960,5235,3825,2355,382,116,382,173700.0,61800,74,1205,1587,126700,1.0
742,13614,41318,0,9508,40901,30905,16316,4167,249,4167,2376900.0,73800,182,9447,13614,174700,1.0
1127,186861,535187,2905,148172,532016,409155,203904,53779,4306,53779,62174700.0,206400,2198,133082,186861,73900,0.0
693,2432,7207,15,1982,7168,5247,2927,982,145,982,647700.0,77000,23,1450,2432,86200,1.0
733,3476,10822,15,2351,10713,8013,4395,1028,215,1028,596600.0,65200,38,2448,3476,165400,1.0
784,72379,269624,1113,56237,267399,187960,80021,26778,2362,26778,20845700.0,115500,1922,45601,72379,128800,1.0
1297,222331,711421,5184,193160,706155,535905,233699,48797,4244,48797,63963200.0,233300,2768,173534,222331,175600,0.0
732,702,1929,0,518,1861,1560,922,133,25,133,99200.0,128600,14,569,702,126000,0.0
644,2462,7891,0,1928,7798,5818,3179,878,70,878,404400.0,80300,54,1584,2462,114300,1.0
858,648,1592,7,481,1588,1244,877,134,0,134,96300.0,146400,39,514,648,149400,0.0
800,10958,31540,0,8437,30869,24861,13194,5150,407,5150,3906600.0,86800,16,5808,10958,139000,1.0
576,5737,21839,0,3439,20143,16965,7224,1272,76,1272,643700.0,49100,115,4465,5737,180700,1.0
782,15185,39064,21,11235,38565,30787,16807,4729,260,4729,3335100.0,144700,155,10456,15185,141100,0.0
614,2064,5895,0,1458,5809,4446,2892,649,80,649,306000.0,57500,45,1415,2064,152200,1.0
571,4339,13095,12,3180,11336,10267,5186,1254,94,1254,586700.0,66400,51,3085,4339,124000,1.0
592,1696,3875,0,1093,3853,3185,2196,469,32,469,226200.0,60500,61,1227,1696,130600,1.0
679,3845,11434,0,2520,10935,8844,5579,1261,199,1261,704800.0,48500,51,2584,3845,207900,1.0
748,6565,17596,26,4327,17413,14115,9049,1439,60,1439,791300.0,99500,356,5126,6565,158700,1.0
790,4230,11089,0,2688,10978,9249,5753,990,66,990,712400.0,230800,39,3240,4230,123200,0.0
724,11974,35444,24,7563,34511,27873,17079,2977,579,2977,1674900.0,97400,1096,8997,11974,89300,0.0
808,94020,254574,510,69089,240730,200680,107716,35839,3094,35839,27777000.0,101300,1223,58181,94020,143700,1.0
513,1200,3631,16,768,3311,2943,1941,272,82,272,125900.0,64200,95,928,1200,165800,1.0
725,581,2083,0,452,1526,1464,743,152,0,152,46000.0,87000,10,429,581,211300,1.0
763,6118,18947,31,4791,18733,13594,7050,2140,191,2140,1369400.0,88000,172,3978,6118,87300,0.0
971,117455,321184,1354,91441,316262,251351,142115,39582,4742,39582,39354500.0,171600,2567,77873,117455,108300,0.0
790,263200,834825,5099,203009,809637,627228,289883,101092,12866,101092,78631600.0,116600,4036,162108,263200,80100,0.0
549,2286,7418,0,1389,6511,6097,3185,679,215,679,204800.0,70800,88,1607,2286,121000,1.0
875,326,889,0,236,889,676,418,84,7,84,42800.0,135700,8,242,326,222300,1.0
722,343,721,0,149,721,582,734,80,0,80,35200.0,66600,76,263,343,189100,1.0
722,7312,21456,3,4394,18722,17780,10733,1149,133,1149,672900.0,81500,146,6163,7312,137000,1.0
629,8624,27015,0,5953,26603,20552,11092,2340,414,2340,1247100.0,77800,78,6284,8624,85400,1.0
630,2287,5599,0,1770,5528,4285,2719,826,63,826,447700.0,86500,41,1461,2287,179500,1.0
729,33171,93635,125,23182,88253,74078,39489,11588,1439,11588,8353300.0,109400,721,21583,33171,239400,1.0
621,3351,8793,14,2406,8725,7128,4153,599,17,599,317200.0,125600,10,2752,3351,109900,0.0
617,3932,9220,0,2768,9135,7570,5482,1777,274,1777,1022500.0,113400,70,2155,3932,139400,1.0
475,275,680,0,204,633,540,462,73,7,73,19600.0,70500,7,202,275,105300,1.0
699,232523,839539,959,169290,831048,588338,267791,75574,6844,75574,50150900.0,82400,3435,156949,232523,209400,1.0
873,77801,222277,178,57065,219907,173356,89246,26526,2951,26526,23414100.0,144800,1403,51275,77801,123200,0.0
851,3234,8650,12,2196,8448,6920,3790,843,28,843,684400.0,172200,158,2391,3234,73600,0.0
526,1411,3836,0,965,3757,2983,1783,384,0,384,205000.0,80600,122,1027,1411,140400,1.0
678,4235,12651,3,3066,12507,9145,5018,907,147,907,526800.0,150300,52,3328,4235,250600,1.0
871,19562,63357,348,16404,62937,44296,20985,4063,525,4063,3577100.0,196300,169,15499,19562,177600,0.0
983,52385,155577,334,35412,154159,117402,64509,15663,1159,15663,15515200.0,240300,989,36722,52385,152100,0.0
918,2514,7246,1,1613,7169,5759,5954,478,46,478,372700.0,190200,168,2036,2514,98200,0.0
1230,14781,39731,329,12450,39599,30642,27484,3882,875,3882,5184400.0,558300,140,10899,14781,83400,0.0
777,3873,9544,4,2979,9478,7655,5224,1163,487,1163,815600.0,230900,13,2710,3873,97900,0.0
725,516,1860,0,313,1826,1486,924,61,23,61,35500.0,143800,34,455,516,103400,0.0
597,601,2307,0,391,2302,1635,2983,140,92,140,65400.0,160400,85,461,601,94500,0.0
1257,9040,29306,5,7558,29135,20909,12194,2731,188,2731,3413200.0,357300,164,6309,9040,92900,0.0
687,2313,6414,6,1640,6347,4577,2985,670,48,670,390000.0,147300,91,1643,2313,106500,0.0
709,17035,52182,158,13311,51771,37082,18434,4048,214,4048,2895700.0,179600,179,12987,17035,149300,0.0
716,15575,48504,47,11825,48077,36053,20500,5552,831,5552,3943200.0,183100,492,10023,15575,136700,0.0
714,8366,28892,4,6043,26303,22149,10671,2173,172,2173,1476000.0,169400,72,6193,8366,103000,0.0
740,7171,20961,45,5062,20614,15345,8655,1668,149,1668,1153400.0,152800,167,5503,7171,121900,0.0
954,155664,576496,4588,135193,573027,396971,163289,50961,2381,50961,51317800.0,256900,1619,104703,155664,124500,0.0
825,81298,244101,2068,64603,241225,181131,89495,22892,1756,22892,18999800.0,183100,1461,58406,81298,164100,0.0
848,6650,20259,48,5124,19892,13935,10051,1709,253,1709,1297500.0,178100,174,4941,6650,123900,0.0
629,4019,15193,26,2729,14938,10930,5936,784,160,784,462600.0,136600,59,3235,4019,164200,1.0
1015,363058,1106700,20673,305366,1098968,828965,384127,121730,7302,121730,127241300.0,260700,4031,241328,363058,111700,0.0
952,10616,36343,122,8532,35993,25394,13466,2512,824,2512,2159700.0,194800,412,8104,10616,157300,0.0
-666666666,168,702,0,108,581,565,1217,11,3,11,,202900,21,157,168,98500,0.0
986,101422,334977,3873,85990,331753,235882,105561,22979,1097,22979,23476700.0,246500,1220,78443,101422,107600,0.0
574,990,2700,0,705,2672,2088,1649,232,50,232,106100.0,175800,41,758,990,167600,0.0
651,7841,20512,40,5508,20310,15619,9770,2129,392,2129,1402200.0,129900,225,5712,7841,104000,0.0
607,3564,10410,52,2463,10355,7526,4584,716,194,716,345500.0,136200,161,2848,3564,119100,0.0
1156,3236,11014,16,2762,11014,7562,3405,500,16,500,523400.0,311000,82,2736,3236,79700,0.0
745,36829,120288,1175,30963,119544,86948,39998,13601,1070,13601,11058300.0,202400,501,23228,36829,34100,0.0
788,1756,5020,0,1292,4814,4005,3885,351,93,351,212000.0,166300,128,1405,1756,262400,1.0
728,3287,10694,9,2614,10558,7432,3644,630,11,630,373100.0,175800,13,2657,3287,84500,0.0
821,25160,59676,307,17579,59102,50368,34256,7019,622,7019,5620000.0,177600,444,18141,25160,90100,0.0
736,11498,26951,6,7551,26283,22218,17080,2550,251,2550,1743500.0,161100,206,8948,11498,88100,0.0
1028,2952,6950,9,2270,6946,5889,5212,590,55,590,579000.0,274700,134,2362,2952,91900,0.0
847,12275,28901,71,8925,28820,24048,15242,2364,139,2364,1967600.0,188300,210,9911,12275,58200,0.0
1186,64906,160985,2021,51627,159670,134995,68453,23926,678,23926,28440000.0,280000,365,40980,64906,97500,0.0
894,10401,25191,66,7671,25115,20479,13431,2974,119,2974,2428200.0,225200,265,7427,10401,88200,0.0
892,24121,55485,172,17251,54714,46509,34628,6817,629,6817,6242900.0,216300,581,17304,24121,85600,0.0
930,18649,48816,129,14064,48369,39137,22307,4801,265,4801,4170600.0,209100,272,13848,18649,125700,0.0
737,12094,30576,17,8353,30184,25163,16274,3244,229,3244,2264000.0,164500,320,8850,12094,172900,1.0
862,19059,43332,248,13526,42900,36414,30267,6153,342,6153,5057800.0,212000,294,12906,19059,170600,0.0
858,15280,36054,89,10297,35608,29869,21108,4141,265,4141,3536900.0,208600,124,11139,15280,66200,0.0
955,14701,36825,137,10954,36578,31135,17213,4053,268,4053,3594100.0,237000,253,10648,14701,83400,0.0
688,2720,6203,4,1715,6203,5227,5125,572,55,572,365400.0,128900,39,2148,2720,114000,0.0
880,24719,58691,324,18254,58211,48580,30510,7010,331,7010,5880200.0,217200,482,17709,24719,138000,0.0
885,2899,7022,24,2022,7009,6032,3323,484,26,484,347100.0,163000,57,2415,2899,76800,0.0
1092,16837,49795,246,12898,48449,38576,18307,4565,74,4565,4860400.0,266400,381,12272,16837,132500,0.0
945,10347,28033,31,7650,27716,22821,11655,2365,313,2365,2057000.0,160100,214,7982,10347,87200,0.0
957,7260,19213,69,5883,19011,15022,8091,1408,62,1408,1087900.0,242500,81,5852,7260,95600,0.0
1113,38208,103218,149,30255,102592,82869,40325,7138,277,7138,7580100.0,267600,707,31070,38208,97300,0.0
676,4480,12369,36,2890,11423,10233,5981,1253,0,1253,707900.0,108400,46,3227,4480,128500,1.0
918,13470,35265,222,9602,34728,28429,14976,3064,82,3064,2507300.0,235200,362,10406,13470,129100,0.0
738,2119,5495,7,1371,5278,4247,2355,1217,50,1217,843900.0,115700,24,902,2119,85300,0.0
635,11892,29048,55,7825,28845,23869,14318,2856,512,2856,1452900.0,127400,273,9036,11892,101600,0.0
1201,83031,235410,552,68227,223040,184865,88856,24188,2267,24188,29211800.0,260900,1043,58843,83031,140500,0.0
1001,7092,17582,75,4899,17440,13933,7754,2621,71,2621,2623600.0,163300,167,4471,7092,173900,1.0
857,16848,53064,548,14141,52322,45244,18154,10403,786,10403,9623000.0,196200,80,6445,16848,79700,0.0
1189,40015,105105,685,30281,103506,85803,44391,14556,1467,14556,16696400.0,329600,555,25459,40015,92700,0.0
639,2561,6524,15,1666,5729,5626,3292,445,0,445,246400.0,109300,27,2116,2561,93200,0.0
816,30927,77319,70,22006,76915,63383,36313,5760,593,5760,4341000.0,198100,394,25167,30927,93400,0.0
898,13238,33149,2,9457,32858,27427,14769,1964,251,1964,1709400.0,220000,210,11274,13238,142200,0.0
721,5705,17048,63,3988,15071,14135,7365,1407,96,1407,851900.0,132500,162,4298,5705,109900,0.0
634,15104,39539,99,9003,37390,32557,17929,4649,602,4649,2386100.0,84500,337,10455,15104,94900,1.0
685,7418,17077,82,4511,16899,13934,8757,3046,379,3046,2088300.0,114100,71,4372,7418,84000,0.0
688,2399,5675,0,1546,5496,4657,3018,594,224,594,381200.0,72200,23,1805,2399,87300,1.0
988,36616,95536,980,27556,91055,75129,40889,16680,1695,16680,16213700.0,169400,551,19936,36616,125600,0.0
1118,4649,14817,372,3431,14604,13366,5132,2451,193,2451,2865100.0,307000,38,2198,4649,52800,0.0
1296,167731,450057,2140,137192,425182,359211,182723,60635,5044,60635,80352400.0,267300,2884,107096,167731,74700,0.0
653,6866,15489,30,4197,15238,12928,8047,1641,235,1641,924700.0,113600,149,5225,6866,96200,0.0
563,12517,29767,4,8093,29618,24525,16745,2757,279,2757,1276600.0,107300,356,9760,12517,88900,0.0
580,2837,6788,23,1872,6515,5592,3484,1163,227,1163,680500.0,105500,172,1674,2837,75100,0.0
644,22388,54457,31,14809,53690,45579,25911,5462,296,5462,3227100.0,137200,461,16926,22388,92300,0.0
961,7412,17596,21,5095,17418,14556,10860,1717,184,1717,1486600.0,203100,309,5695,7412,60600,0.0
754,5774,12254,20,3397,12254,10642,9203,857,83,857,525900.0,277900,454,4917,5774,72300,0.0
734,9467,23694,23,6540,23490,19470,11702,2942,184,2942,1895200.0,172200,194,6525,9467,86800,0.0
641,14577,34330,66,9793,33251,28901,17289,3962,322,3962,2425900.0,139600,276,10615,14577,98800,0.0
940,14190,38991,32,10804,38640,31250,16188,3303,544,3303,2926500.0,231000,162,10887,14190,66400,0.0
1663,68663,154710,20985,59086,151720,129075,75489,39087,3194,39087,65012600.0,537900,614,29576,68663,109500,0.0
628,18517,41911,352,12120,40766,33527,22206,8673,826,8673,5539500.0,90900,368,9844,18517,118100,1.0
1123,10419,28135,636,8527,27936,22773,11545,6673,596,6673,7613800.0,341200,222,3746,10419,79100,0.0
1062,53555,136255,1554,41077,130988,110113,60092,23084,2618,23084,24608500.0,186600,984,30471,53555,149500,0.0
731,12110,31819,70,8495,31639,26363,14138,2797,254,2797,1895000.0,151500,174,9313,12110,129000,0.0
1895,102310,229534,37538,87911,225319,193542,111646,56785,4200,56785,110439200.0,643300,377,45525,102310,108900,0.0
478,1847,4458,30,1276,4392,3579,3353,482,112,482,202600.0,151100,70,1365,1847,104900,0.0
831,9123,22353,92,6464,21987,17335,10271,4470,458,4470,3710400.0,122400,149,4653,9123,201300,1.0
611,9022,22611,39,4550,21666,19093,11579,1906,550,1906,1041300.0,71900,76,7116,9022,88200,1.0
985,68665,180775,2364,54339,171249,142480,77442,34320,4506,34320,34526900.0,189300,1144,34345,68665,142100,0.0
1121,30495,83784,75,24064,82671,66697,33091,6875,344,6875,7473600.0,239100,474,23620,30495,58500,0.0
1481,45345,141159,2930,39416,135615,108301,47345,10968,603,10968,16668900.0,327600,607,34377,45345,100500,0.0
835,28150,79237,991,20566,77742,65731,32309,14172,1452,14172,12020400.0,153800,514,13978,28150,74600,0.0
1458,24333,67196,105,19529,63621,52911,27497,6786,984,6786,10076900.0,315400,345,17547,24333,86500,0.0
942,89238,220892,5397,66115,218218,184587,99737,52048,3880,52048,49892400.0,209200,1081,37190,89238,137200,0.0
642,5740,13256,76,3719,12867,10366,7105,2575,363,2575,1621900.0,90100,84,3165,5740,130800,1.0
688,6523,14863,11,4481,14812,12392,10087,1838,184,1838,1109300.0,231400,160,4685,6523,110500,0.0
864,4470,11083,10,3145,11006,8946,5833,1317,147,1317,956500.0,177200,125,3153,4470,127200,0.0
667,26687,61970,40,18617,60872,51243,31622,6619,433,6619,3867900.0,113800,487,20068,26687,51200,0.0
549,1786,4043,0,1074,3987,3199,1922,918,31,918,484700.0,92500,0,868,1786,85700,0.0
806,10477,24273,39,7403,23668,20254,11782,4451,580,4451,3812000.0,162500,163,6026,10477,89600,0.0
1252,9794,26109,22,6989,24860,21390,10763,1883,30,1883,1842600.0,228100,243,7911,9794,91400,0.0
729,4699,12802,70,3497,12706,10353,5505,771,40,771,496500.0,185100,42,3928,4699,65000,0.0
779,5503,17380,40,4039,17279,15775,6507,2944,624,2944,2542500.0,160600,54,2559,5503,67400,0.0
973,10520,27516,77,7880,27284,21907,11855,5718,541,5718,5668800.0,226200,243,4802,10520,196700,0.0
771,13528,32840,61,9116,32470,26777,21243,4062,177,4062,2728900.0,157200,368,9466,13528,168100,1.0
527,2344,5131,0,1415,5114,4213,2912,610,30,610,346800.0,164800,84,1734,2344,58500,0.0
611,6434,15594,41,4339,15479,12844,7981,1238,124,1238,602100.0,153800,223,5196,6434,138900,0.0
683,7088,16867,3,4899,16756,13795,8346,1788,149,1788,1099700.0,114500,53,5300,7088,87700,0.0
513,6653,15708,45,4066,15069,13315,9218,1415,133,1415,581400.0,95700,271,5238,6653,72700,0.0
780,5633,15537,12,3643,14131,12835,6749,2315,96,2315,1632400.0,134800,66,3318,5633,64400,0.0
1056,3131,7359,27,2105,7347,6228,3945,777,50,777,715700.0,358600,65,2354,3131,78300,0.0
622,17330,42689,19,10872,41458,35357,20788,4026,431,4026,2145500.0,96500,486,13304,17330,125800,1.0
742,2606,6495,0,1960,6410,5268,2895,983,168,983,675100.0,111700,66,1623,2606,141600,1.0
1775,5308,13843,1502,4667,13780,10699,5805,2130,288,2130,3752500.0,742000,76,3178,5308,111200,0.0
1635,4778,16117,501,4326,16074,12264,4895,1554,75,1554,2551900.0,263300,21,3224,4778,75300,0.0
882,13262,32037,336,9292,31078,26040,16385,7730,997,7730,6540000.0,112900,208,5532,13262,109100,0.0
1173,4583,12022,0,3475,11800,9746,4775,924,0,924,1158500.0,316800,21,3659,4583,88400,0.0
837,3388,11595,17,2260,7015,10048,4145,993,65,993,648100.0,121600,104,2395,3388,151600,1.0
1803,8499,23580,1277,7042,23005,19061,8843,2550,159,2550,4479200.0,501900,0,5949,8499,111600,0.0
835,9128,21620,57,6363,21481,17076,9956,3752,210,3752,3001000.0,161600,395,5376,9128,204500,1.0
1439,12540,41379,783,10873,41293,31476,13451,4561,338,4561,6759700.0,307000,286,7979,12540,116600,0.0
776,42333,99572,1644,31436,98290,79703,47083,20356,2119,20356,15996100.0,133700,910,21977,42333,92200,0.0
874,9997,25521,35,7498,24722,21153,10838,3446,300,3446,2983900.0,174000,76,6551,9997,150600,0.0
1083,32331,88057,70,25128,85835,68423,35591,9951,848,9951,10627600.0,238200,542,22380,32331,83300,0.0
1003,87249,245752,4279,68102,218544,201089,96700,49395,4268,49395,52190900.0,194800,1321,37854,87249,143800,0.0
600,4493,12176,5,2712,12039,9886,6330,1295,7,1295,631700.0,107500,16,3198,4493,90900,0.0
1180,120907,335594,752,98663,333209,264311,127750,29860,2451,29860,35860400.0,224200,1520,91047,120907,148800,0.0
1823,393380,1142004,58372,335829,1128951,900852,411223,126673,6632,126673,232344200.0,534800,3292,266707,393380,76800,0.0
769,3649,11606,26,2725,8497,9862,4169,895,9,895,619900.0,89400,109,2754,3649,97400,1.0
1018,14157,36090,32,10545,35592,29352,15358,3218,255,3218,2853800.0,249100,128,10939,14157,131700,0.0
1202,28410,73028,256,19846,71521,60048,32357,7293,1369,7293,9475800.0,328700,506,21117,28410,118900,0.0
544,11102,27725,0,6415,27496,23018,13543,2459,299,2459,995800.0,94900,235,8643,11102,92300,0.0
847,3470,8334,9,2412,8217,6481,3860,1744,61,1744,1362600.0,186100,68,1726,3470,80000,0.0
598,12829,31298,50,8247,30741,25926,15405,3814,237,3814,1939200.0,89600,270,9015,12829,213300,1.0
1089,18408,46487,1770,14880,46110,39906,20334,10292,825,10292,11684500.0,277800,192,8116,18408,113800,0.0
785,1935,7113,0,1049,5640,6693,2248,788,158,788,591500.0,252500,0,1147,1935,110500,0.0
747,22608,55158,11,16411,54688,45332,25570,5661,170,5661,3953400.0,154300,159,16947,22608,200500,1.0
1095,126115,324073,1796,101906,321871,257176,135397,46804,4177,46804,52528900.0,223900,3086,79311,126115,155000,0.0
586,22161,51956,118,13987,51381,42971,26243,5941,634,5941,3236400.0,94300,395,16220,22161,211700,1.0
1178,8972,25564,178,7523,25132,19731,9925,2192,222,2192,2411700.0,294300,210,6780,8972,140300,0.0
932,13451,34813,102,9489,34716,28340,17021,2730,216,2730,2238900.0,212900,292,10721,13451,119200,0.0
1094,6079,16329,36,4788,16276,12913,6760,846,0,846,713200.0,199700,110,5233,6079,287800,1.0
817,5081,10848,17,2781,10757,9431,7581,1362,148,1362,939200.0,226900,154,3719,5081,323600,1.0
530,9278,24428,16,5173,22891,20403,11782,2607,173,2607,1181800.0,81700,274,6671,9278,244200,1.0
924,3766,8830,14,2304,8753,7651,5736,518,104,518,383900.0,227200,159,3248,3766,269900,1.0
793,4522,10710,10,2549,10368,9304,7285,863,33,863,623600.0,248400,192,3659,4522,112300,0.0
764,7281,22903,18,4960,21937,19561,9383,2559,0,2559,1751600.0,154800,77,4722,7281,228800,1.0
1295,11298,37704,52,8925,32782,30591,12336,3588,142,3588,4402300.0,212100,60,7710,11298,111000,0.0
816,3250,8873,30,2175,7153,7532,3916,912,75,912,712000.0,163200,151,2338,3250,159000,0.0
848,30503,78653,50,22951,78289,63105,34891,8152,505,8152,6786200.0,206700,510,22351,30503,106400,0.0
529,8976,22290,5,5235,21586,18557,11939,2045,288,2045,771700.0,90500,224,6931,8976,68300,0.0
1400,43279,130159,1600,35389,129423,101035,46594,9797,982,9797,13355900.0,265600,580,33482,43279,99800,0.0
920,2773,6670,76,2096,6670,5600,3545,663,16,663,363400.0,172700,97,2110,2773,108200,0.0
683,5948,15462,37,4239,15386,12485,7201,1131,0,1131,657100.0,151700,40,4817,5948,129000,0.0
1031,5568,14331,8,3974,14152,11767,6286,1392,149,1392,1431700.0,333100,20,4176,5568,93400,0.0
660,23203,56277,112,15983,55925,46769,29767,4810,570,4810,2732600.0,176900,406,18393,23203,100200,0.0
845,2811,7052,7,1930,7052,5821,3477,598,16,598,426700.0,170000,36,2213,2811,99600,0.0
690,11785,30959,29,7215,30051,25797,18877,3282,35,3282,1963500.0,125300,194,8503,11785,95800,0.0
936,35577,97692,2120,27878,97058,84187,39571,16057,1697,16057,15550900.0,213300,377,19520,35577,111400,0.0
882,7555,20523,12,5831,19979,16748,8071,1373,21,1373,1214900.0,256600,22,6182,7555,131400,0.0
857,28790,74390,148,21151,70859,61581,32153,6016,699,6016,5059000.0,206300,559,22774,28790,154100,0.0
818,3972,9797,3,2723,9785,8069,4694,1102,68,1102,785500.0,146600,0,2870,3972,172000,1.0
569,6096,15181,7,2996,14726,12486,7587,1466,182,1466,678100.0,77500,154,4630,6096,109300,1.0
1096,8257,22148,44,6265,20993,18510,9040,1071,125,1071,934500.0,327700,12,7186,8257,194200,0.0
595,14084,35030,36,8997,34329,28588,18168,3864,13,3864,1889800.0,110800,120,10220,14084,104800,0.0
1764,121299,374558,7440,109223,372353,277105,126162,26862,1326,26862,46739900.0,475500,1386,94437,121299,233400,0.0
742,5107,13108,18,3400,12931,10607,6027,1358,62,1358,790600.0,256500,80,3749,5107,120900,0.0
1620,139306,450763,12216,122898,442944,339476,145961,38358,3441,38358,62294700.0,358300,1452,100948,139306,104700,0.0
907,38434,93419,200,28102,91796,76667,40694,9683,604,9683,8752600.0,192100,635,28751,38434,75700,0.0
724,6664,18089,3,4809,16591,14990,7592,1891,166,1891,1137400.0,172800,119,4773,6664,101400,0.0
555,1163,2213,0,678,2213,1943,2069,169,23,169,84500.0,184000,57,994,1163,83600,0.0
693,6048,16435,12,3995,14661,13854,8224,1576,88,1576,861900.0,110900,84,4472,6048,136200,1.0
996,10815,29889,44,8367,27795,23698,12107,2147,102,2147,1893400.0,193200,291,8668,10815,229500,1.0
923,14746,37035,64,10766,36422,30636,16334,3368,76,3368,3120200.0,224100,166,11378,14746,133300,0.0
713,5177,11998,54,3170,11703,9857,7384,1833,3,1833,1200200.0,165800,205,3344,5177,262400,1.0
544,7713,17958,0,4792,17670,15189,10176,1771,228,1771,858400.0,116000,187,5942,7713,272400,1.0
983,9974,28364,4,7731,25757,23910,10556,1020,0,1020,991200.0,264300,151,8954,9974,203400,0.0
742,9160,22440,36,6062,22242,19001,11352,2120,220,2120,1926400.0,197200,367,7040,9160,496200,1.0
831,17262,42854,53,11874,42467,34718,21130,5227,311,5227,4309300.0,204000,395,12035,17262,437200,1.0
1229,23981,68406,411,19140,68002,54211,26413,5178,403,5178,6075800.0,370000,436,18803,23981,1009500,1.0
700,27542,68438,192,18794,67830,55435,31631,7029,647,7029,4254300.0,110000,647,20513,27542,191200,1.0
625,17846,42906,241,12150,42314,35702,20975,5464,844,5464,3298600.0,114800,283,12382,17846,400000,1.0
576,3825,10005,8,2365,9947,8228,5836,818,41,818,306300.0,82100,70,3007,3825,235200,1.0
495,2808,7450,8,1533,7427,6196,3973,453,51,453,163300.0,79900,50,2355,2808,284600,1.0
751,7118,17510,0,4523,17344,14611,9901,1342,226,1342,827300.0,170600,254,5776,7118,305400,1.0
536,8046,21241,3,4680,21181,16949,9930,1825,106,1825,576200.0,82000,112,6221,8046,443700,1.0
664,31069,77097,45,20131,74497,62561,36173,8333,971,8333,4699800.0,105700,790,22736,31069,377500,1.0
524,5498,14345,4,3582,14003,11864,7434,1231,101,1231,441800.0,91100,71,4267,5498,249800,1.0
791,21734,56644,15,15567,56260,45403,23978,4067,400,4067,2864500.0,157500,665,17667,21734,202800,1.0
553,6293,16790,18,4018,16627,13802,7901,1785,140,1785,735400.0,101200,134,4508,6293,237500,1.0
603,9298,23236,0,4966,23118,18817,11155,2150,574,2150,1084100.0,71800,214,7148,9298,559700,1.0
529,7702,19707,4,3296,18103,16115,11228,1585,204,1585,514800.0,34800,358,6117,7702,269400,1.0
649,16305,41063,76,9466,40917,33413,19328,4123,523,4123,1889700.0,90600,127,12182,16305,262200,1.0
613,9169,22130,0,4895,22053,18092,10908,1692,181,1692,659100.0,67900,106,7477,9169,441100,1.0
630,11149,29123,23,6741,28947,23632,13378,2506,196,2506,1302500.0,113300,198,8643,11149,375400,1.0
614,25019,60963,58,14694,60532,49833,30000,7060,972,7060,3849200.0,89400,619,17959,25019,161300,1.0
662,9341,24604,11,5956,24425,20119,11293,2379,148,2379,1193200.0,111900,73,6962,9341,80600,0.0
508,3690,8637,4,2023,8581,7078,5445,1057,31,1057,364800.0,68400,45,2633,3690,286700,1.0
964,42456,111610,429,32650,111091,87423,47213,11108,851,11108,10026200.0,168200,907,31348,42456,154500,0.0
573,17697,44602,34,10862,43454,36413,21563,3808,477,3808,1974300.0,86400,254,13889,17697,279100,1.0
567,4372,11673,50,2716,11567,9640,6558,886,206,886,466300.0,144600,141,3486,4372,425500,1.0
594,9676,23412,25,5884,22924,19346,13936,3432,150,3432,1400400.0,136700,421,6244,9676,135700,0.0
634,5482,13210,0,3120,12223,11286,7700,1427,110,1427,661300.0,95100,92,4055,5482,157500,1.0
589,9961,23067,28,6731,22835,19461,10870,2521,163,2521,1265400.0,91000,108,7440,9961,163300,1.0
558,2662,8570,0,1521,7934,7252,3930,425,54,425,101400.0,105900,84,2237,2662,212900,1.0
700,15255,35523,59,9911,34922,29221,19221,4178,316,4178,2580300.0,115400,484,11077,15255,149500,1.0
668,5561,13812,21,3923,13754,11328,8217,1510,249,1510,896600.0,121900,213,4051,5561,331100,1.0
732,22718,56575,152,15682,56202,46497,26349,5644,644,5644,3628500.0,110100,441,17074,22718,295800,1.0
586,11274,27421,77,7438,27194,22578,13125,3744,303,3744,1749800.0,129800,341,7530,11274,91900,0.0
600,10910,25150,0,5766,25066,20176,12793,2855,202,2855,1169200.0,71000,234,8055,10910,251500,1.0
648,12760,29921,216,8786,29678,24693,14413,3611,480,3611,2334200.0,89800,94,9149,12760,239000,1.0
622,6586,16371,0,4259,16216,13262,7957,1952,118,1952,1008100.0,98600,23,4634,6586,144700,1.0
608,12695,32006,39,8197,31626,26102,15785,2771,346,2771,1564600.0,99800,188,9924,12695,422300,1.0
573,10671,25496,35,6510,25357,20856,13143,2197,182,2197,861800.0,88900,109,8474,10671,213900,1.0
612,3647,8574,24,2194,8293,7250,8903,667,87,667,291100.0,117200,80,2980,3647,198000,1.0
507,2951,7035,3,1841,6858,5981,5372,563,212,563,209600.0,104300,131,2388,2951,150300,1.0
618,3563,8949,0,2057,8873,7385,4994,798,24,798,331100.0,92400,94,2765,3563,179800,1.0
585,11391,29152,0,7335,27365,24148,14232,3156,223,3156,1689100.0,99800,310,8235,11391,222700,1.0
481,5815,14348,0,3463,14254,11583,7421,1197,59,1197,422600.0,92700,85,4618,5815,117900,1.0
577,6616,16977,0,4359,16544,13919,7539,1419,116,1419,713800.0,100200,161,5197,6616,81800,0.0
513,2427,5800,0,1470,5800,4638,3290,402,32,402,141900.0,81400,46,2025,2427,89800,1.0
676,36110,86016,257,23963,85505,69837,40243,10423,663,10423,6494400.0,115100,595,25687,36110,97800,0.0
441,3365,8901,17,1883,8853,7138,4630,626,41,626,169700.0,79100,7,2739,3365,173900,1.0
528,2703,8305,0,1679,6951,7173,3511,695,16,695,293700.0,91600,0,2008,2703,176500,1.0
565,11079,27000,17,6628,26359,22056,13051,2493,159,2493,941200.0,78300,223,8586,11079,255000,1.0
788,38410,103715,1146,29116,102154,88638,44816,16261,2305,16261,13566800.0,178200,634,22149,38410,234800,1.0
604,5815,13517,0,3383,13401,11137,7630,1143,51,1143,520400.0,105700,126,4672,5815,123800,1.0
647,2868,7527,0,2044,6965,6286,3394,528,42,528,255800.0,104700,57,2340,2868,184400,1.0
630,5979,15793,3,3410,15693,12995,8155,1263,173,1263,625500.0,90700,193,4716,5979,243100,1.0
707,40239,96100,512,26141,94638,78949,46407,15716,1571,15716,10412200.0,119800,723,24523,40239,468200,1.0
979,20808,55673,562,16300,55320,44487,22813,5388,427,5388,5298300.0,227300,288,15420,20808,126900,0.0
712,80267,187827,1596,55327,186020,154009,92487,24798,2320,24798,15827700.0,111200,2415,55469,80267,129200,1.0
605,13978,34428,0,7967,33884,28085,16840,3641,898,3641,1712900.0,85800,401,10337,13978,210100,1.0
578,3032,7138,7,1785,6966,6029,5196,611,26,611,301500.0,107900,9,2421,3032,85600,0.0
630,12420,33760,70,8550,31138,27944,15113,2260,122,2260,1122100.0,106600,302,10160,12420,86200,0.0
657,17075,41377,109,10809,40865,32794,22897,5573,145,5573,3108800.0,169100,303,11502,17075,60800,0.0
894,17648,43726,160,13211,43293,36899,23062,7476,579,7476,6762900.0,256700,275,10172,17648,63800,0.0
1134,106229,269885,2188,79149,263479,217580,113936,38367,2316,38367,44060800.0,255500,1190,67862,106229,184900,0.0
903,70363,190529,861,53616,189040,145128,74009,22427,1477,22427,20720200.0,198600,568,47936,70363,105000,0.0
745,1759,3999,27,1038,3941,3361,2156,510,25,510,342500.0,161700,45,1249,1759,126800,0.0
1094,167717,457474,4562,128712,454847,357192,176422,57370,2370,57370,64532700.0,272400,1824,110347,167717,126900,0.0
739,9235,22259,33,6023,22065,18228,9984,2704,120,2704,2052700.0,176700,191,6531,9235,120300,0.0
691,5824,19261,18,4688,19040,13188,6479,2079,87,2079,1363900.0,150300,138,3745,5824,165300,1.0
598,1007,2226,0,619,2203,1787,1254,312,15,312,183800.0,143800,45,695,1007,61300,0.0
925,23034,61569,509,13695,60400,51137,33190,5249,535,5249,4621500.0,206700,779,17785,23034,211800,0.0
1007,47341,121725,519,33075,120489,97671,52971,15261,531,15261,15843800.0,269100,588,32080,47341,159800,0.0
662,17534,43858,125,11161,43591,35397,21519,4008,328,4008,2592000.0,184600,446,13526,17534,81700,0.0
842,194995,490764,5504,143041,481783,393019,211007,73221,3957,73221,65157700.0,195500,2892,121774,194995,92600,0.0
713,4416,10344,7,2669,10233,8436,5953,929,118,929,551600.0,150500,128,3487,4416,171000,1.0
830,27383,75138,374,19035,74493,59212,36914,9376,1074,9376,7609700.0,256400,283,18007,27383,81200,0.0
895,13903,30524,209,7474,29748,27054,18295,3692,234,3692,3325200.0,304000,472,10211,13903,127400,0.0
1116,100484,258903,10700,73269,244971,211249,110944,33407,2601,33407,37130100.0,277500,1697,67077,100484,234300,0.0
1379,851077,2118119,145138,692082,2104848,1726169,902107,362523,15245,362523,513061300.0,446600,7989,488554,851077,153000,0.0
703,8786,20940,33,4385,20699,17761,16038,2085,191,2085,1368300.0,163400,329,6701,8786,207700,1.0
782,5637,13066,0,3248,12954,10864,8152,1249,124,1249,799300.0,186000,127,4388,5637,88100,0.0
965,7718,16221,167,4613,16171,14294,13912,2000,167,2000,1761500.0,452300,255,5718,7718,290400,0.0
747,4713,11498,12,3066,11459,9548,5766,1448,37,1448,1037700.0,248500,83,3265,4713,181600,0.0
737,17657,47794,1029,14028,47532,41358,20321,9801,1343,9801,7832600.0,199400,145,7856,17657,93300,0.0
797,81720,248279,563,62504,245349,181605,87777,30495,1571,30495,23714200.0,163500,1070,51225,81720,268100,1.0
875,32280,73439,291,18347,72516,62110,36492,9800,473,9800,8470100.0,227400,726,22480,32280,165900,0.0
796,40668,103590,88,27041,102583,82500,44216,13693,614,13693,11193900.0,186600,597,26975,40668,116700,0.0
646,3056,7568,5,1628,7495,6359,4492,904,65,904,497600.0,165900,104,2152,3056,94300,0.0
791,8247,21172,0,5179,21130,17460,10196,2675,235,2675,1916100.0,219200,181,5572,8247,87200,0.0
834,30036,76012,194,19302,75155,61276,34753,9370,564,9370,7818500.0,176000,843,20666,30036,128600,0.0
836,14706,40585,146,11056,40443,30895,16637,4369,221,4369,3408300.0,229100,198,10337,14706,98800,0.0
771,28070,71454,222,17656,68514,58156,35850,9523,575,9523,7085000.0,161800,776,18547,28070,77000,0.0
1117,34027,80323,939,22898,74912,66940,41287,10847,656,10847,11889300.0,311400,566,23180,34027,142800,0.0
1116,312839,845193,13595,241426,822539,665599,339302,121226,7421,121226,137774100.0,255800,5246,191613,312839,65900,0.0
717,1823,4105,37,945,4060,3521,2108,346,8,346,248300.0,202600,34,1477,1823,192400,0.0
847,25835,89124,221,21328,87039,62457,27103,8000,302,8000,6713800.0,177400,154,17835,25835,174000,0.0
843,22391,59862,148,15927,56631,48312,24354,7938,425,7938,6930300.0,196300,352,14453,22391,117500,0.0
752,30512,93420,781,23047,92914,68278,36484,11584,1041,11584,8699700.0,161700,441,18928,30512,75900,0.0
972,83475,212738,2415,60338,211156,175216,94452,31915,1555,31915,32960100.0,299800,1158,51560,83475,113500,0.0
1269,284477,771904,20410,228402,762452,614842,302725,95046,5030,95046,121665200.0,338400,2731,189431,284477,205600,0.0
949,17588,48116,627,15181,47651,35905,20034,5013,818,5013,4729800.0,213900,446,12575,17588,74000,0.0
836,7063,18791,121,5447,18684,14199,9234,1524,242,1524,1288000.0,205900,169,5539,7063,139800,0.0
886,3778,8562,8,2551,8499,6744,4598,1060,120,1060,917500.0,255200,0,2718,3778,155800,0.0
852,32984,81023,130,25921,79886,63679,36385,11008,1040,11008,9759700.0,198600,400,21976,32984,137000,0.0
902,38447,97031,241,29771,93741,77019,42424,11797,1057,11797,11108200.0,202800,403,26650,38447,198000,0.0
711,5630,14166,278,4436,14112,11003,6623,1507,198,1507,971700.0,197200,188,4123,5630,154600,0.0
615,982,2479,4,603,2171,2120,1354,279,22,279,128600.0,152500,27,703,982,136800,0.0
1272,8795,22923,533,7129,22865,18845,13508,3653,1044,3653,4719500.0,739100,93,5142,8795,395800,0.0
870,16269,44527,580,13814,44244,33763,19526,4268,1292,4268,3609900.0,201000,590,12001,16269,179100,0.0
679,3740,8703,13,2696,8596,7116,4799,884,88,884,454200.0,169900,171,2856,3740,143600,0.0
810,13130,29964,15,9736,29498,24172,14651,4129,109,4129,3234900.0,240900,22,9001,13130,147600,0.0
651,4481,11920,0,3261,11686,9285,5454,1226,108,1226,579600.0,151900,62,3255,4481,168100,1.0
759,3010,7347,28,2260,7281,5754,3637,622,65,622,389000.0,219000,57,2388,3010,142300,0.0
759,11811,29276,31,8762,29039,24143,14192,3277,668,3277,2162400.0,236200,118,8534,11811,171000,0.0
748,16009,37944,425,13585,37737,32257,19048,8069,1003,8069,6253400.0,223000,141,7940,16009,233900,1.0
851,6205,15689,28,4929,14874,12355,8734,1815,348,1815,1195600.0,158600,227,4390,6205,177300,1.0
715,5328,13479,0,3581,13104,11022,6032,1278,31,1278,780600.0,154900,153,4050,5328,207500,1.0
652,7705,20758,312,5988,20575,15228,8941,2149,290,2149,1364800.0,178400,237,5556,7705,317700,1.0
627,3490,8253,0,2531,8090,6556,3858,833,156,833,470900.0,165500,16,2657,3490,649800,1.0
725,2246,4741,12,1549,4663,3867,2589,519,54,519,302700.0,147700,61,1727,2246,78900,0.0
742,15167,40354,91,11424,39700,31232,17950,4468,239,4468,2940300.0,189700,184,10699,15167,87800,0.0
1078,3197,10037,0,2733,10016,7774,5953,778,319,778,570500.0,264800,120,2419,3197,140300,0.0
769,3182,7117,306,2348,6758,5744,3564,745,38,745,608100.0,180100,0,2437,3182,98100,0.0
782,64482,161226,442,47816,159873,126948,68761,20209,692,20209,15569900.0,135000,539,44273,64482,99400,0.0
615,8769,20344,40,6289,20130,15997,10671,2031,122,2031,1256800.0,129300,114,6738,8769,109700,0.0
669,9851,24170,15,6408,22996,20177,15033,1821,204,1821,1139700.0,140500,235,8030,9851,139700,0.0
720,8163,20111,11,4672,18996,17482,17608,1247,213,1247,792700.0,127800,376,6916,8163,84300,0.0
660,6859,15004,153,4472,14903,12705,13230,1133,237,1133,596900.0,163400,261,5726,6859,132300,0.0
687,6714,16755,13,4979,16667,13136,7271,1629,73,1629,1005500.0,126600,80,5085,6714,106000,0.0
798,17832,45303,34,13324,44469,35010,19758,5360,413,5360,4163000.0,144100,513,12472,17832,53500,0.0
779,15302,41226,19,12098,40959,33581,16439,4161,355,4161,3256200.0,193300,124,11141,15302,104700,0.0
675,32223,73427,81,23281,72797,59245,34732,8731,564,8731,6204300.0,127700,504,23492,32223,96800,0.0
644,6504,15779,83,4428,15560,12673,9651,2049,235,2049,1250600.0,107400,136,4455,6504,82000,0.0
744,19345,49737,53,15476,49565,38716,20317,3717,316,3717,2842600.0,168400,90,15628,19345,74500,0.0
498,1979,4354,7,1214,4297,3725,4809,267,6,267,117200.0,132600,118,1712,1979,94200,0.0
814,32739,84586,98,25426,84133,68209,35571,9933,583,9933,7967700.0,177500,476,22806,32739,109000,0.0
884,63286,167886,804,48598,165980,132745,70050,21747,1644,21747,19366300.0,164100,1327,41539,63286,87200,0.0
517,2948,5748,7,1835,5642,5016,6008,702,133,702,332000.0,107200,155,2246,2948,90100,0.0
602,12755,34513,1,9133,34030,25477,15122,2834,207,2834,1493900.0,117400,269,9921,12755,157800,1.0
929,33389,87142,219,27272,86320,67146,35152,8123,443,8123,7566100.0,223000,305,25266,33389,98400,0.0
642,15634,37465,22,11338,37205,30888,23972,2607,171,2607,1572700.0,156700,310,13027,15634,224200,1.0
627,12560,27994,52,9005,27430,23352,17038,2828,187,2828,1667900.0,135500,255,9732,12560,74900,0.0
681,21793,51651,50,15891,50177,42249,25620,5746,362,5746,3995900.0,142300,326,16047,21793,79600,0.0
686,19133,45358,52,13420,44788,36696,23856,4886,511,4886,3168000.0,145500,343,14247,19133,108000,0.0
667,7573,16384,124,5088,16101,13435,16285,2045,124,2045,1172900.0,161700,270,5528,7573,95600,0.0
661,7932,18745,23,5516,18554,14971,10689,2048,221,2048,1401400.0,139300,292,5884,7932,97400,0.0
570,6567,13566,3,4476,13376,11611,10952,1429,211,1429,787400.0,120000,209,5138,6567,149500,1.0
710,6389,15164,49,4243,14997,12564,9916,1218,83,1218,748200.0,144000,207,5171,6389,165200,1.0
669,18548,40712,31,12164,40217,33922,30668,4747,57,4747,3019400.0,116600,310,13801,18548,148100,1.0
844,382027,956586,24941,287074,947277,748510,418013,192341,11500,192341,168004800.0,150300,4109,189686,382027,91300,0.0
841,75640,195101,1273,57626,190815,154261,82497,23452,1650,23452,19768700.0,165200,749,52188,75640,87900,0.0
721,69759,169540,674,53640,164505,138230,74841,24732,1684,24732,18798800.0,147300,1004,45027,69759,121300,0.0
742,16652,44260,10,12648,43932,36342,18316,5247,454,5247,4010300.0,156700,219,11405,16652,113200,0.0
507,4040,9035,5,2532,8834,7392,9141,1015,120,1015,455000.0,131400,149,3025,4040,96200,0.0
712,14957,36869,24,11514,36515,29359,15979,3930,137,3930,2723400.0,163600,225,11027,14957,93700,0.0
664,19444,51742,72,14420,50611,42249,21981,5996,563,5996,3951200.0,137200,350,13448,19444,96700,0.0
669,6294,14211,30,4170,14077,11565,9097,1417,141,1417,826700.0,106300,103,4877,6294,140600,1.0
611,17024,41136,42,11944,40565,33183,20806,4027,130,4027,2361400.0,135800,202,12997,17024,87200,0.0
680,47532,115094,186,36412,112857,92026,50821,14447,435,14447,9801100.0,149800,360,33085,47532,120700,0.0
609,8646,19190,28,5920,18974,15912,12473,2014,75,2014,1103500.0,106200,116,6632,8646,90900,0.0
465,1354,4506,33,893,4462,3233,2332,456,0,456,192500.0,85400,14,898,1354,123700,1.0
769,72288,183288,725,57360,181919,144197,75875,21299,1148,21299,16385200.0,160100,925,50989,72288,115300,0.0
647,12095,30378,78,8349,30075,23351,13967,2763,73,2763,1641900.0,148900,324,9332,12095,123900,0.0
698,5723,13243,7,3996,13163,10812,6725,1415,71,1415,890800.0,150400,159,4308,5723,110800,0.0
767,23317,56790,65,18102,55411,45734,26447,6076,632,6076,4633100.0,180100,330,17241,23317,131600,0.0
626,8234,20378,34,5966,20248,16470,9403,1797,254,1797,1068700.0,155900,69,6437,8234,105000,0.0
792,46966,117582,574,36952,116244,96500,49723,16983,1016,16983,13800700.0,161300,623,29983,46966,110300,0.0
746,103267,258004,931,81280,255051,202425,108200,36003,1986,36003,27483700.0,163200,1188,67264,103267,85400,0.0
787,40528,102388,438,31157,101687,83775,43422,15055,975,15055,11770500.0,156200,395,25473,40528,137800,0.0
709,54820,135293,274,42697,134234,107639,58817,14909,720,14909,10437400.0,147600,619,39911,54820,109400,0.0
747,14994,35352,68,9895,34844,30032,30723,2447,952,2447,1682600.0,165000,322,12547,14994,124900,0.0
740,18189,43328,30,13109,42885,35090,24456,3933,321,3933,2714000.0,158300,284,14256,18189,231000,1.0
682,11892,29510,36,8900,29112,23026,12953,3314,205,3314,2084700.0,147000,143,8578,11892,115800,0.0
677,7142,15638,33,4669,15457,12953,13199,1540,213,1540,939300.0,147000,91,5602,7142,102700,0.0
978,156996,396731,1167,122002,394253,320353,163755,37275,1700,37275,38265900.0,262700,1532,119721,156996,79500,0.0
769,33987,87833,29,25695,83556,71842,37552,10074,993,10074,7636100.0,156200,562,23913,33987,104300,0.0
833,40246,102917,290,30647,102212,83263,51993,12709,866,12709,10978400.0,192500,841,27537,40246,86100,0.0
673,10758,21465,1,6620,21288,18291,25615,2533,931,2533,1538500.0,206500,498,8225,10758,112000,0.0
574,6610,16313,23,4585,15616,13321,8930,1577,103,1577,902200.0,127000,131,5033,6610,179300,1.0
715,10149,26427,53,7012,24801,21712,14998,2330,389,2330,1532800.0,120100,479,7819,10149,216900,1.0
648,34119,79680,141,24773,79237,65188,37356,8514,741,8514,5553900.0,126200,623,25605,34119,107800,0.0
757,25678,63340,41,19646,62624,50514,30171,8036,313,8036,5998800.0,172500,497,17642,25678,88500,0.0
873,53756,133967,392,42217,133151,107370,55999,12074,692,12074,11112600.0,219600,529,41682,53756,132700,0.0
693,7284,15239,10,4597,15098,12810,15413,1400,73,1400,819600.0,150800,165,5884,7284,104700,0.0
764,25247,63445,36,18696,61142,50681,28003,7017,383,7017,5175800.0,154900,180,18230,25247,108500,0.0
983,216930,522837,15688,178956,518927,425119,226189,90533,3511,90533,95274300.0,242700,1952,126397,216930,132400,0.0
756,13159,27443,51,9141,27124,23558,24562,2858,1451,2858,2039900.0,204700,173,10301,13159,117000,0.0
747,18717,43503,326,13684,42909,35571,23086,6138,320,6138,4374900.0,140400,303,12579,18717,108700,0.0
734,41387,102082,165,31623,100380,82241,44820,11921,859,11921,9038900.0,149400,636,29466,41387,91400,0.0
646,8154,20531,11,5860,19443,16494,9898,2080,130,2080,1185900.0,129400,166,6074,8154,136900,1.0
730,9799,23576,23,7711,23400,18702,10821,2529,120,2529,1779300.0,171700,127,7270,9799,121000,0.0
599,3005,7282,5,2130,7185,5887,3643,565,73,565,299100.0,143800,103,2440,3005,112700,0.0
867,35044,87817,359,27410,87307,71143,36945,8676,499,8676,7966500.0,262100,231,26368,35044,115900,0.0
708,28072,70371,111,21431,70079,58106,30633,8801,780,8801,6260600.0,158800,315,19271,28072,102300,0.0
646,7564,17626,47,5336,17490,14166,8924,1950,145,1950,1102100.0,134400,105,5614,7564,148700,1.0
